//New HSK (2013)/Level 1
爱[愛]	ài
八[八]	bā
爸爸[爸爸]	bàba
杯子[杯子]	bēizi
北京[北京]	Běijīng
本[本]	běn
不[不]	bù
不客气[不客氣]	bú kèqi
菜[菜]	cài
茶[茶]	chá
吃[吃]	chī
出租车[出租車]	chūzūchē
打电话[打電話]	dǎ diànhuà
大[大]	dà
的[的]	de
点[點]	diǎn
电脑[電腦]	diànnǎo
电视[電視]	diànshì
电影[電影]	diànyǐng
东西[東西]	dōngxi
都[都]	dōu
读[讀]	dú
对不起[對不起]	duìbuqǐ
多[多]	duō
多少[多少]	duōshao
儿子[兒子]	érzi
二[二]	èr
饭店[飯店]	fàndiàn
飞机[飛機]	fēijī
分钟[分鐘]	fēnzhōng
高兴[高興]	gāoxìng
个[個]	ge
工作[工作]	gōngzuò
狗[狗]	gǒu
汉语[漢語]	Hànyǔ
好[好]	hǎo
号[號]	hào
喝[喝]	hē
和[和]	hé
很[很]	hěn
后面[后面]	hòumian
回[回]	huí
会[會]	huì
几[幾]	jǐ
家[家]	jiā
叫[叫]	jiào
今天[今天]	jīntiān
九[九]	jiǔ
开[開]	kāi
看[看]	kàn
看见[看見]	kànjiàn
块[塊]	kuài
来[來]	lái
老师[老師]	lǎoshī
了[了]	le
冷[冷]	lěng
里[裡]	lǐ
六[六]	liù
妈妈[媽媽]	māma
吗[嗎]	ma
买[買]	mǎi
猫[貓]	māo
没关系[沒關系]	méiguānxi
没有[沒有]	méiyǒu
米饭[米飯]	mǐfàn
名字[名字]	míngzi
明天[明天]	míngtiān
哪[哪]	nǎ
哪儿[哪兒]	nǎr
那[那]	nà
呢[呢]	ne
能[能]	néng
你[你]	nǐ
年[年]	nián
女儿[女兒]	nǚ'ér
朋友[朋友]	péngyou
漂亮[漂亮]	piàoliang
苹果[蘋果]	píngguǒ
七[七]	qī
前面[前面]	qiánmiàn
钱[錢]	qián
请[請]	qǐng
去[去]	qù
热[熱]	rè
人[人]	rén
认识[認識]	rènshi
三[三]	sān
商店[商店]	shāngdiàn
上[上]	shàng
上午[上午]	shàngwǔ
少[少]	shǎo
谁[誰]	shéi
什么[什麼]	shénme
十[十]	shí
时候[時候]	shíhou
是[是]	shì
书[書]	shū
水[水]	shuǐ
水果[水果]	shuǐguǒ
睡觉[睡覺]	shuìjiào
说[說]	shuō
四[四]	sì
岁[歲]	suì
他[他]	tā
她[她]	tā
太[太]	tài
天气[天氣]	tiānqì
听[聽]	tīng
同学[同學]	tóngxué
喂[喂]	wéi
我[我]	wǒ
我们[我們]	wǒmen
五[五]	wǔ
喜欢[喜歡]	xǐhuan
下[下]	xià
下午[下午]	xiàwǔ
下雨[下雨]	xiàyǔ
先生[先生]	xiānsheng
现在[現在]	xiànzài
想[想]	xiǎng
小[小]	xiǎo
小姐[小姐]	xiǎojie
些[些]	xiē
写[寫]	xiě
谢谢[謝謝]	xièxie
星期[星期]	xīngqī
学生[學生]	xuésheng
学习[學習]	xuéxí
学校[學校]	xuéxiào
一[一]	yī
一点儿[一點兒]	yìdiǎnr
衣服[衣服]	yīfu
医生[醫生]	yīshēng
医院[醫院]	yīyuàn
椅子[椅子]	yǐzi
有[有]	yǒu
月[月]	yuè
再见[再見]	zàijiàn
在[在]	zài
怎么[怎麼]	zěnme
怎么样[怎麼樣]	zěnmeyàng
这[這]	zhè
中国[中國]	Zhōngguó
中午[中午]	zhōngwǔ
住[住]	zhù
桌子[桌子]	zhuōzi
字[字]	zì
昨天[昨天]	zuótiān
坐[坐]	zuò
做[做]	zuò

//New HSK (2013)/Level 2
吧[吧]	ba
白[白]	bái
百[百]	bǎi
帮助[幫助]	bāngzhù
报纸[報紙]	bàozhǐ
比[比]	bǐ
别[別]	bié
宾馆[賓館]	bīnguǎn
长[長]	cháng, zhǎng
唱歌[唱歌]	chànggē
出[出]	chū
穿[穿]	chuān
次[次]	cì
从[從]	cóng
错[錯]	cuò
打篮球[打籃球]	dǎ lánqiú
大家[大家]	dàjiā
到[到]	dào
得[得]	de
等[等]	děng
弟弟[弟弟]	dìdi
第一[第一]	dìyī
懂[懂]	dǒng
对[對]	duì
房间[房間]	fángjiān
非常[非常]	fēicháng
服务员[服務員]	fúwùyuán
高[高]	gāo
告诉[告訴]	gàosu
哥哥[哥哥]	gēge
给[給]	gěi
公共汽车[公共汽車]	gōnggòng qìchē
公司[公司]	gōngsī
贵[貴]	guì
过[過]	guò
还[還]	hái
孩子[孩子]	háizi
好吃[好吃]	hǎochī
黑[黑]	hēi
红[紅]	hóng
火车站[火車站]	huǒchēzhàn
机场[機場]	jīchǎng
鸡蛋[雞蛋]	jīdàn
件[件]	jiàn
教室[教室]	jiàoshì
姐姐[姐姐]	jiějie
介绍[介紹]	jièshào
进[進]	jìn
近[近]	jìn
就[就]	jiù
觉得[覺得]	juéde
咖啡[咖啡]	kāfēi
开始[開始]	kāishǐ
考试[考試]	kǎoshì
可能[可能]	kěnéng
可以[可以]	kěyǐ
课[課]	kè
快[快]	kuài
快乐[快樂]	kuàilè
累[累]	lèi
离[離]	lí
两[兩]	liǎng
零[零]	líng
路[路]	lù
旅游[旅游]	lǚyóu
卖[賣]	mài
慢[慢]	màn
忙[忙]	máng
每[每]	měi
妹妹[妹妹]	mèimei
门[門]	mén
面条[面條]	miàntiáo
男[男]	nán
您[您]	nín
牛奶[牛奶]	niúnǎi
女[女]	nǚ
旁边[旁邊]	pángbiān
跑步[跑步]	pǎobù
便宜[便宜]	piányi
票[票]	piào
妻子[妻子]	qīzi
起床[起床]	qǐ chuáng
千[千]	qiān
铅笔[鉛筆]	qiānbǐ
晴[晴]	qíng
去年[去年]	qùnián
让[讓]	ràng
日[日]	rì
上班[上班]	shàngbān
身体[身體]	shēntǐ
生病[生病]	shēngbìng
生日[生日]	shēngrì
时间[時間]	shíjiān
事情[事情]	shìqing
手表[手表]	shǒubiǎo
手机[手機]	shǒujī
说话[說話]	shuōhuà
送[送]	sòng
虽然[雖然]	suīrán
但是[但是]	dànshì
它[它]	tā
踢足球[踢足球]	tīzúqiú
题[題]	tí
跳舞[跳舞]	tiàowǔ
外[外]	wài
完[完]	wán
玩[玩]	wán
晚上[晚上]	wǎnshang
往[往]	wǎng
为什么[為什麼]	wèishénme
问[問]	wèn
问题[問題]	wèntí
西瓜[西瓜]	xīguā
希望[希望]	xīwàng
洗[洗]	xǐ
小时[小時]	xiǎoshí
笑[笑]	xiào
新[新]	xīn
姓[姓]	xìng
休息[休息]	xiūxi
雪[雪]	xuě
颜色[顏色]	yánsè
眼睛[眼睛]	yǎnjing
羊肉[羊肉]	yángròu
药[藥]	yào
要[要]	yào
也[也]	yě
一起[一起]	yìqǐ
一下[一下]	yíxià
已经[已經]	yǐjing
意思[意思]	yìsi
因为[因為]	yīnwèi
所以[所以]	suǒyǐ
阴[陰]	yīn
游泳[游泳]	yóuyǒng
右边[右邊]	yòubian
鱼[魚]	yú
远[遠]	yuǎn
运动[運動]	yùndòng
再[再]	zài
早上[早上]	zǎoshang
丈夫[丈夫]	zhàngfu
找[找]	zhǎo
着[著]	zhe
真[真]	zhēn
正在[正在]	zhèngzài
知道[知道]	zhīdao
准备[准備]	zhǔnbèi
走[走]	zǒu
最[最]	zuì
左边[左邊]	zuǒbian

//New HSK (2013)/Level 3
阿姨[阿姨]	āyí
啊[啊]	a
矮[矮]	ǎi
爱好[愛好]	àihào
安静[安靜]	ānjìng
把[把]	bǎ
班[班]	bān
搬[搬]	bān
办法[辦法]	bànfǎ
办公室[辦公室]	bàngōngshì
半[半]	bàn
帮忙[幫忙]	bāngmáng
包[包]	bāo
饱[飽]	bǎo
北方[北方]	běifāng
被[被]	bèi
鼻子[鼻子]	bízi
比较[比較]	bǐjiào
比赛[比賽]	bǐsài
笔记本[筆記本]	bǐjìběn
必须[必須]	bìxū
变化[變化]	biànhuà
别人[別人]	biéren
冰箱[冰箱]	bīngxiāng
不但[不但]	búdàn
而且[而且]	érqiě
菜单[菜單]	càidān
参加[參加]	cānjiā
草[草]	cǎo
层[層]	céng
差[差]	chà
超市[超市]	chāoshì
衬衫[襯衫]	chènshān
成绩[成績]	chéngjì
城市[城市]	chéngshì
迟到[遲到]	chídào
除了[除了]	chúle
船[船]	chuán
春[春]	chūn
词典[詞典]	cídiǎn
聪明[聰明]	cōngming
打扫[打掃]	dǎsǎo
打算[打算]	dǎsuàn
带[帶]	dài
担心[擔心]	dānxīn
蛋糕[蛋糕]	dàngāo
当然[當然]	dāngrán
地[地]	dì, de
灯[燈]	dēng
地方[地方]	dìfang
地铁[地鐵]	dìtiě
地图[地圖]	dìtú
电梯[電梯]	diàntī
电子邮件[電子郵件]	diànzǐ yóujiàn
东[東]	dōng
冬[冬]	dōng
动物[動物]	dòngwù
短[短]	duǎn
段[段]	duàn
锻炼[鍛煉]	duànliàn
多么[多麼]	duōme
饿[餓]	è
耳朵[耳朵]	ěrduo
发[發]	fā, fà
发烧[發燒]	fāshāo
发现[發現]	fāxiàn
方便[方便]	fāngbiàn
放[放]	fàng
放心[放心]	fàngxīn
分[分]	fēn, fèn
附近[附近]	fùjìn
复习[復習]	fùxí
干净[干淨]	gānjìng
感冒[感冒]	gǎnmào
感兴趣[感興趣]	gǎn xìngqù
刚才[剛才]	gāngcái
个子[個子]	gèzi
根据[根據]	gēnjù
跟[跟]	gēn
更[更]	gèng
公斤[公斤]	gōngjīn
公园[公園]	gōngyuán
故事[故事]	gùshi
刮风[刮風]	guāfēng
关[關]	guān
关系[關系]	guānxi
关心[關心]	guānxīn
关于[關於]	guānyú
国家[國家]	guójiā
过[過]	guò
过去[過去]	guòqù
还是[還是]	háishi
害怕[害怕]	hàipà
黑板[黑板]	hēibǎn
后来[后來]	hòulái
护照[護照]	hùzhào
花[花]	huā
画[畫]	huà
坏[壞]	huài
欢迎[歡迎]	huānyíng
还[還]	hái
环境[環境]	huánjìng
换[換]	huàn
黄河[黃河]	huánghé
回答[回答]	huídá
会议[會議]	huìyì
或者[或者]	huòzhě
几乎[幾乎]	jīhū
机会[機會]	jīhuì
极[極]	jí
记得[記得]	jìde
季节[季節]	jìjié
检查[檢查]	jiǎnchá
简单[簡單]	jiǎndān
见面[見面]	jiànmiàn
健康[健康]	jiànkāng
讲[講]	jiǎng
教[教]	jiāo, jiào
角[角]	jiǎo, jué
脚[腳]	jiǎo
接[接]	jiē
街道[街道]	jiēdào
节目[節目]	jiémù
节日[節日]	jiérì
结婚[結婚]	jiéhūn
结束[結束]	jiéshù
解决[解決]	jiějué
借[借]	jiè
经常[經常]	jīngcháng
经过[經過]	jīngguò
经理[經理]	jīnglǐ
久[久]	jiǔ
旧[舊]	jiù
句子[句子]	jùzi
决定[決定]	juédìng
可爱[可愛]	kě'ài
渴[渴]	kě
刻[刻]	kè
客人[客人]	kèrén
空调[空調]	kōngtiáo
口[口]	kǒu
哭[哭]	kū
裤子[褲子]	kùzi
筷子[筷子]	kuàizi
蓝[藍]	lán
老[老]	lǎo
离开[離開]	líkāi
礼物[禮物]	lǐwù
历史[歷史]	lìshǐ
脸[臉]	liǎn
练习[練習]	liànxí
辆[輛]	liàng
聊天[聊天]	liáotiān
了解[了解]	liǎojiě
邻居[鄰居]	línjū
留学[留學]	liúxué
楼[樓]	lóu
绿[綠]	lǜ
马[馬]	mǎ
马上[馬上]	mǎshàng
满意[滿意]	mǎnyì
帽子[帽子]	màozi
米[米]	mǐ
面包[面包]	miànbāo
明白[明白]	míngbai
拿[拿]	ná
奶奶[奶奶]	nǎinai
南[南]	nán
难[難]	nán
难过[難過]	nánguò
年级[年級]	niánjí
年轻[年輕]	niánqīng
鸟[鳥]	niǎo
努力[努力]	nǔlì
爬山[爬山]	páshān
盘子[盤子]	pánzi
胖[胖]	pàng
皮鞋[皮鞋]	píxié
啤酒[啤酒]	píjiǔ
瓶子[瓶子]	píngzi
其实[其實]	qíshí
其他[其他]	qítā
奇怪[奇怪]	qíguài
骑[騎]	qí
起飞[起飛]	qǐfēi
起来[起來]	qǐlai
清楚[清楚]	qīngchu
请假[請假]	qǐngjià
秋[秋]	qiū
裙子[裙子]	qúnzi
然后[然后]	ránhòu
热情[熱情]	rèqíng
认为[認為]	rènwéi
认真[認真]	rènzhēn
容易[容易]	róngyì
如果[如果]	rúguǒ
伞[傘]	sǎn
上网[上網]	shàngwǎng
生气[生氣]	shēngqì
声音[聲音]	shēngyīn
世界[世界]	shìjiè
试[試]	shì
瘦[瘦]	shòu
叔叔[叔叔]	shūshu
舒服[舒服]	shūfu
树[樹]	shù
数学[數學]	shùxué
刷牙[刷牙]	shuāyá
双[雙]	shuāng
水平[水平]	shuǐpíng
司机[司機]	sījī
太阳[太陽]	tàiyáng
特别[特別]	tèbié
疼[疼]	téng
提高[提高]	tígāo
体育[體育]	tǐyù
甜[甜]	tián
条[條]	tiáo
同事[同事]	tóngshì
同意[同意]	tóngyì
头发[頭發]	tóufa
突然[突然]	tūrán
图书馆[圖書館]	túshūguǎn
腿[腿]	tuǐ
完成[完成]	wánchéng
碗[碗]	wǎn
万[萬]	wàn
忘记[忘記]	wàngjì
为[為]	wèi
为了[為了]	wèile
位[位]	wèi
文化[文化]	wénhuà
西[西]	xī
习惯[習慣]	xíguàn
洗手间[洗手間]	xǐshǒujiān
洗澡[洗澡]	xǐzǎo
夏[夏]	xià
先[先]	xiān
相信[相信]	xiāngxìn
香蕉[香蕉]	xiāngjiāo
向[向]	xiàng
像[像]	xiàng
小心[小心]	xiǎoxīn
校长[校長]	xiàozhǎng
新闻[新聞]	xīnwén
新鲜[新鮮]	xīnxiān
信用卡[信用卡]	xìnyòngkǎ
行李箱[行李箱]	xínglǐxiāng
熊猫[熊貓]	xióngmāo
需要[需要]	xūyào
选择[選擇]	xuǎnzé
要求[要求]	yāoqiú
爷爷[爺爺]	yéye
一般[一般]	yìbān
一边[一邊]	yìbiān
一定[一定]	yídìng
一共[一共]	yígòng
一会儿[一會兒]	yíhuìr
一样[一樣]	yíyàng
一直[一直]	yìzhí
以前[以前]	yǐqián
音乐[音樂]	yīnyuè
银行[銀行]	yínháng
饮料[飲料]	yǐnliào
应该[應該]	yīnggāi
影响[影響]	yǐngxiǎng
用[用]	yòng
游戏[游戲]	yóuxì
有名[有名]	yǒumíng
又[又]	yòu
遇到[遇到]	yùdào
元[元]	yuán
愿意[願意]	yuànyì
月亮[月亮]	yuèliang
越[越]	yuè
站[站]	zhàn
张[張]	zhāng
长[長]	cháng, zhǎng
着急[著急]	zháojí
照顾[照顧]	zhàogu
照片[照片]	zhàopiàn
照相机[照相機]	zhàoxiàngjī
只[隻]	zhī, zhǐ
只有[隻有]	zhǐyǒu
才[才]	cái
中间[中間]	zhōngjiān
中文[中文]	Zhōngwén
终于[終於]	zhōngyú
种[種]	zhǒng
重要[重要]	zhòngyào
周末[周末]	zhōumò
主要[主要]	zhǔyào
注意[注意]	zhùyì
自己[自己]	zìjǐ
自行车[自行車]	zìxíngchē
总是[總是]	zǒngshì
嘴[嘴]	zuǐ
最后[最后]	zuìhòu
最近[最近]	zuìjìn
作业[作業]	zuòyè

//New HSK (2013)/Level 4
爱情[愛情]	àiqíng
安排[安排]	ānpái
安全[安全]	ānquán
按时[按時]	ànshí
按照[按照]	ànzhào
百分之[百分之]	bǎifēnzhī
棒[棒]	bàng
包子[包子]	bāozi
保护[保護]	bǎohù
保证[保證]	bǎozhèng
报名[報名]	bào míng
抱[抱]	bào
抱歉[抱歉]	bàoqiàn
倍[倍]	bèi
本来[本來]	běnlái
笨[笨]	bèn
比如[比如]	bǐrú
毕业[畢業]	bì yè
遍[遍]	biàn
标准[標准]	biāozhǔn
表格[表格]	biǎogé
表示[表示]	biǎoshì
表演[表演]	biǎoyǎn
表扬[表揚]	biǎoyáng
饼干[餅幹]	bǐnggān
并且[並且]	bìngqiě
博士[博士]	bóshì
不得不[不得不]	bù dé bù
不管[不管]	bùguǎn
不过[不過]	búguò
不仅[不僅]	bùjǐn
部分[部分]	bùfen
擦[擦]	cā
猜[猜]	cāi
材料[材料]	cáiliào
参观[參觀]	cānguān
餐厅[餐廳]	cāntīng
厕所[廁所]	cèsuǒ
差不多[差不多]	chàbuduō
长城[長城]	chángchéng
长江[長江]	Chángjiāng
尝[嘗]	cháng
场[場]	chǎng
超过[超過]	chāoguò
成功[成功]	chénggōng
成为[成爲]	chéngwéi
诚实[誠實]	chéngshí
乘坐[乘坐]	chéngzuò
吃惊[吃驚]	chī jīng
重新[重新]	chóngxīn
抽烟[抽煙]	chōuyān
出差[出差]	chū chāi
出发[出發]	chūfā
出生[出生]	chūshēng
出现[出現]	chūxiàn
厨房[廚房]	chúfáng
传真[傳真]	chuánzhēn
窗户[窗戶]	chuānghu
词语[詞語]	cíyǔ
从来[從來]	cónglái
粗心[粗心]	cūxīn
存[存]	cún
错误[錯誤]	cuòwù
答案[答案]	dá'àn
打扮[打扮]	dǎban
打扰[打擾]	dǎrǎo
打印[打印]	dǎyìn
打招呼[打招呼]	dǎzhāohu
打折[打折]	dǎzhé
打针[打針]	dǎzhēn
大概[大概]	dàgài
大使馆[大使館]	dàshǐguǎn
大约[大約]	dàyuē
大夫[大夫]	dàifu
戴[戴]	dài
当[當]	dāng
当时[當時]	dāngshí
刀[刀]	dāo
导游[導遊]	dǎoyóu
到处[到處]	dàochù
到底[到底]	dào dǐ
倒[倒]	dǎo, dào
道歉[道歉]	dàoqiàn
得意[得意]	déyì
得[得]	de
登机牌[登機牌]	dēngjīpái
等[等]	děng
低[低]	dī
底[底]	dǐ
地点[地點]	dìdiǎn
地球[地球]	dìqiú
地址[地址]	dìzhǐ
调查[調查]	diàochá
掉[掉]	diào
丢[丟]	diū
动作[動作]	dòngzuò
堵车[堵車]	dǔchē
肚子[肚子]	dùzi
短信[短信]	duǎnxìn
对话[對話]	duìhuà
对面[對面]	duìmiàn
对于[對于]	duìyú
儿童[兒童]	értóng
而[而]	ér
发生[發生]	fāshēng
发展[發展]	fāzhǎn
法律[法律]	fǎlǜ
翻译[翻譯]	fānyì
烦恼[煩惱]	fánnǎo
反对[反對]	fǎnduì
方法[方法]	fāngfǎ
方面[方面]	fāngmiàn
方向[方向]	fāngxiàng
房东[房東]	fángdōng
放弃[放棄]	fàngqì
放暑假[放暑假]	fàng shǔjià
放松[放松]	fàngsōng
份[份]	fèn
丰富[豐富]	fēngfù
否则[否則]	fǒuzé
符合[符合]	fúhé
父亲[父親]	fùqin
付款[付款]	fù kuǎn
负责[負責]	fùzé
复印[複印]	fùyìn
复杂[複雜]	fùzá
富[富]	fù
改变[改變]	gǎibiàn
干杯[幹杯]	gān bēi
赶[趕]	gǎn
敢[敢]	gǎn
感动[感動]	gǎndòng
感觉[感覺]	gǎnjué
感情[感情]	gǎnqíng
感谢[感謝]	gǎnxiè
干[幹]	gān
刚[剛]	gāng
高速公路[高速公路]	gāosù gōnglù
胳膊[胳膊]	gēbo
各[各]	gè
工资[工資]	gōngzī
公里[公裏]	gōnglǐ
功夫[功夫]	gōngfu
共同[共同]	gòngtóng
购物[購物]	gòuwù
够[夠]	gòu
估计[估計]	gūjì
鼓励[鼓勵]	gǔlì
故意[故意]	gùyì
顾客[顧客]	gùkè
挂[挂]	guà
关键[關鍵]	guānjiàn
观众[觀衆]	guānzhòng
管理[管理]	guǎnlǐ
光[光]	guāng
广播[廣播]	guǎngbō
广告[廣告]	guǎnggào
逛[逛]	guàng
规定[規定]	guīdìng
国籍[國籍]	guójí
国际[國際]	guójì
果汁[果汁]	guǒzhī
过程[過程]	guòchéng
海洋[海洋]	hǎiyáng
害羞[害羞]	hài xiū
寒假[寒假]	hánjià
汗[汗]	hàn
航班[航班]	hángbān
好处[好處]	hǎochu
好像[好像]	hǎoxiàng
号码[號碼]	hàomǎ
合格[合格]	hégé
合适[合適]	héshì
盒子[盒子]	hézi
后悔[後悔]	hòuhuǐ
厚[厚]	hòu
互联网[互聯網]	Hùliánwǎng
互相[互相]	hùxiāng
护士[護士]	hùshi
怀疑[懷疑]	huáiyí
回忆[回憶]	huíyì
活动[活動]	huódòng
活泼[活潑]	huópo
火[火]	huǒ
获得[獲得]	huòdé
积极[積極]	jījí
积累[積累]	jīlěi
基础[基礎]	jīchǔ
激动[激動]	jīdòng
及时[及時]	jíshí
即使[即使]	jíshǐ
计划[計劃]	jìhuà
记者[記者]	jìzhě
技术[技術]	jìshù
既然[既然]	jìrán
继续[繼續]	jìxù
寄[寄]	jì
加班[加班]	jiā bān
加油站[加油站]	jiāyóuzhàn
家具[家具]	jiājù
假[假]	jiǎ, jià
价格[價格]	jiàgé
坚持[堅持]	jiānchí
减肥[減肥]	jiǎnféi
减少[減少]	jiǎnshǎo
建议[建議]	jiànyì
将来[將來]	jiānglái
奖金[獎金]	jiǎngjīn
降低[降低]	jiàngdī
降落[降落]	jiàngluò
交[交]	jiāo
交流[交流]	jiāoliú
交通[交通]	jiāotōng
郊区[郊區]	jiāoqū
骄傲[驕傲]	jiāo'ào
饺子[餃子]	jiǎozi
教授[教授]	jiàoshòu
教育[教育]	jiàoyù
接受[接受]	jiēshòu
接着[接著]	jiēzhe
节[節]	jié
节约[節約]	jiéyuē
结果[結果]	jiéguǒ
解释[解釋]	jiěshì
尽管[盡管]	jǐnguǎn
紧张[緊張]	jǐnzhāng
进行[進行]	jìnxíng
禁止[禁止]	jìnzhǐ
京剧[京劇]	jīngjù
经济[經濟]	jīngjì
经历[經曆]	jīnglì
经验[經驗]	jīngyàn
精彩[精彩]	jīngcǎi
景色[景色]	jǐngsè
警察[警察]	jǐngchá
竞争[競爭]	jìngzhēng
竟然[竟然]	jìngrán
镜子[鏡子]	jìngzi
究竟[究竟]	jiūjìng
举[舉]	jǔ
举办[舉辦]	jǔbàn
举行[舉行]	jǔxíng
拒绝[拒絕]	jùjué
距离[距離]	jùlí
聚会[聚會]	jùhuì
开玩笑[開玩笑]	kāi wánxiào
开心[開心]	kāixīn
看法[看法]	kànfǎ
考虑[考慮]	kǎolǜ
烤鸭[烤鴨]	kǎoyā
科学[科學]	kēxué
棵[棵]	kē
咳嗽[咳嗽]	késou
可怜[可憐]	kělián
可是[可是]	kěshì
可惜[可惜]	kěxī
客厅[客廳]	kètīng
肯定[肯定]	kěndìng
空[空]	kōng, kòng
空气[空氣]	kōngqì
恐怕[恐怕]	kǒngpà
苦[苦]	kǔ
矿泉水[礦泉水]	kuàngquánshuǐ
困[困]	kùn
困难[困難]	kùnnan
垃圾桶[垃圾桶]	lājītǒng
拉[拉]	lā
辣[辣]	là
来不及[來不及]	lái bu jí
来得及[來得及]	lái de jí
来自[來自]	láizì
懒[懶]	lǎn
浪费[浪費]	làngfèi
浪漫[浪漫]	làngmàn
老虎[老虎]	lǎohǔ
冷静[冷靜]	lěngjìng
礼拜天[禮拜天]	lǐbàitiān
礼貌[禮貌]	lǐmào
理发[理發]	lǐfà
理解[理解]	lǐjiě
理想[理想]	lǐxiǎng
力气[力氣]	lìqi
厉害[厲害]	lìhai
例如[例如]	lìrú
俩[倆]	liǎng
连[連]	lián
联系[聯系]	liánxì
凉快[涼快]	liángkuai
零钱[零錢]	língqián
另外[另外]	lìngwài
留[留]	liú
流利[流利]	liúlì
流行[流行]	liúxíng
旅行[旅行]	lǚxíng
律师[律師]	lǜshī
乱[亂]	luàn
麻烦[麻煩]	máfan
马虎[馬虎]	mǎhu
满[滿]	mǎn
毛[毛]	máo
毛巾[毛巾]	máojīn
美丽[美麗]	měilì
梦[夢]	mèng
迷路[迷路]	mílù
密码[密碼]	mìmǎ
免费[免費]	miǎn fèi
秒[秒]	miǎo
民族[民族]	mínzú
母亲[母親]	mǔqin
目的[目的]	mùdì
耐心[耐心]	nàixīn
难道[難道]	nándào
难受[難受]	nánshòu
内[內]	nèi
内容[內容]	nèiróng
能力[能力]	nénglì
年龄[年齡]	niánlíng
弄[弄]	nòng
暖和[暖和]	nuǎnhuo
偶尔[偶爾]	ǒu'ěr
排队[排隊]	pái duì
排列[排列]	páiliè
判断[判斷]	pànduàn
陪[陪]	péi
批评[批評]	pīpíng
皮肤[皮膚]	pífū
脾气[脾氣]	píqi
篇[篇]	piān
骗[騙]	piàn
乒乓球[乒乓球]	pīngpāngqiú
平时[平時]	píngshí
破[破]	pò
葡萄[葡萄]	pútao
普遍[普遍]	pǔbiàn
普通话[普通話]	pǔtōnghuà
其次[其次]	qícì
其中[其中]	qízhōng
气候[氣候]	qìhòu
千万[千萬]	qiānwàn
签证[簽證]	qiānzhèng
敲[敲]	qiāo
桥[橋]	qiáo
巧克力[巧克力]	qiǎokèlì
亲戚[親戚]	qīnqi
轻[輕]	qīng
轻松[輕松]	qīngsōng
情况[情況]	qíngkuàng
穷[窮]	qióng
区别[區別]	qūbié
取[取]	qǔ
全部[全部]	quánbù
缺点[缺點]	quēdiǎn
缺少[缺少]	quēshǎo
却[卻]	què
确实[確實]	quèshí
然而[然而]	rán'ér
热闹[熱鬧]	rènao
任何[任何]	rènhé
任务[任務]	rènwu
扔[扔]	rēng
仍然[仍然]	réngrán
日记[日記]	rìjì
入口[入口]	rùkǒu
散步[散步]	sàn bù
森林[森林]	sēnlín
沙发[沙發]	shāfā
伤心[傷心]	shāngxīn
商量[商量]	shāngliang
稍微[稍微]	shāowēi
勺子[勺子]	sháozi
社会[社會]	shèhuì
申请[申請]	shēnqǐng
深[深]	shēn
甚至[甚至]	shènzhì
生活[生活]	shēnghuó
生命[生命]	shēngmìng
生意[生意]	shēngyi
省[省]	shěng
剩[剩]	shèng
失败[失敗]	shībài
失望[失望]	shīwàng
师傅[師傅]	shīfu
十分[十分]	shífēn
实际[實際]	shíjì
实在[實在]	shízài
使[使]	shǐ
使用[使用]	shǐyòng
世纪[世紀]	shìjì
是否[是否]	shìfǒu
适合[適合]	shìhé
适应[適應]	shìyìng
收[收]	shōu
收入[收入]	shōurù
收拾[收拾]	shōushi
首都[首都]	shǒudū
首先[首先]	shǒuxiān
受不了[受不了]	shòu bu liǎo
受到[受到]	shòudào
售货员[售貨員]	shòuhuòyuán
输[輸]	shū
熟悉[熟悉]	shúxī
数量[數量]	shùliàng
数字[數字]	shùzì
帅[帥]	shuài
顺便[順便]	shùnbiàn
顺利[順利]	shùnlì
顺序[順序]	shùnxù
说明[說明]	shuōmíng
硕士[碩士]	shuòshì
死[死]	sǐ
速度[速度]	sùdù
塑料袋[塑料袋]	sùliàodài
酸[酸]	suān
随便[隨便]	suíbiàn
随着[隨著]	suízhe
孙子[孫子]	sūnzi
所有[所有]	suǒyǒu
台[台]	tái
抬[擡]	tái
态度[態度]	tàidu
谈[談]	tán
弹钢琴[彈鋼琴]	tán gāngqín
汤[湯]	tāng
糖[糖]	táng
躺[躺]	tǎng
趟[趟]	tàng, tāng
讨论[討論]	tǎolùn
讨厌[討厭]	tǎoyàn
特点[特點]	tèdiǎn
提[提]	tí
提供[提供]	tígōng
提前[提前]	tíqián
提醒[提醒]	tíxǐng
填空[填空]	tiánkòng
条件[條件]	tiáojiàn
停[停]	tíng
挺[挺]	tǐng
通过[通過]	tōngguò
通知[通知]	tōngzhī
同情[同情]	tóngqíng
同时[同時]	tóngshí
推[推]	tuī
推迟[推遲]	tuīchí
脱[脫]	tuō
袜子[襪子]	wàzi
完全[完全]	wánquán
网球[網球]	wǎngqiú
网站[網站]	wǎngzhàn
往往[往往]	wǎngwǎng
危险[危險]	wēixiǎn
卫生间[衛生間]	wèishēngjiān
味道[味道]	wèidao
温度[溫度]	wēndù
文章[文章]	wénzhāng
污染[汙染]	wūrǎn
无[無]	wú
无聊[無聊]	wúliáo
无论[無論]	wúlùn
误会[誤會]	wùhuì
西红柿[西紅柿]	xīhóngshì
吸引[吸引]	xīyǐn
咸[鹹]	xián
现金[現金]	xiànjīn
羡慕[羨慕]	xiànmù
相反[相反]	xiāngfǎn
相同[相同]	xiāngtóng
香[香]	xiāng
详细[詳細]	xiángxì
响[響]	xiǎng
橡皮[橡皮]	xiàngpí
消息[消息]	xiāoxi
小吃[小吃]	xiǎochī
小伙子[小夥子]	xiǎohuǒzi
小说[小說]	xiǎoshuō
笑话[笑話]	xiàohua
效果[效果]	xiàoguǒ
心情[心情]	xīnqíng
辛苦[辛苦]	xīnkǔ
信封[信封]	xìnfēng
信息[信息]	xìnxī
信心[信心]	xìnxīn
兴奋[興奮]	xīngfèn
行[行]	xíng
醒[醒]	xǐng
幸福[幸福]	xìngfú
性别[性別]	xìngbié
性格[性格]	xìnggé
修理[修理]	xiūlǐ
许多[許多]	xǔduō
学期[學期]	xuéqī
压力[壓力]	yālì
呀[呀]	ya
牙膏[牙膏]	yágāo
亚洲[亞洲]	Yàzhōu
严格[嚴格]	yángé
严重[嚴重]	yánzhòng
研究[研究]	yánjiū
盐[鹽]	yán
眼镜[眼鏡]	yǎnjìng
演出[演出]	yǎnchū
演员[演員]	yǎnyuán
阳光[陽光]	yángguāng
养成[養成]	yǎngchéng
样子[樣子]	yàngzi
邀请[邀請]	yāoqǐng
要是[要是]	yàoshi
钥匙[鑰匙]	yàoshi
也许[也許]	yěxǔ
叶子[葉子]	yèzi
页[頁]	yè
一切[一切]	yíqiè
以[以]	yǐ
以为[以爲]	yǐwéi
艺术[藝術]	yìshù
意见[意見]	yìjiàn
因此[因此]	yīncǐ
引起[引起]	yǐnqǐ
印象[印象]	yìnxiàng
赢[贏]	yíng
应聘[應聘]	yìngpìn
永远[永遠]	yǒngyuǎn
勇敢[勇敢]	yǒnggǎn
优点[優點]	yōudiǎn
优秀[優秀]	yōuxiù
幽默[幽默]	yōumò
尤其[尤其]	yóuqí
由[由]	yóu
由于[由于]	yóuyú
邮局[郵局]	yóujú
友好[友好]	yǒuhǎo
友谊[友誼]	yǒuyì
有趣[有趣]	yǒuqù
于是[于是]	yúshì
愉快[愉快]	yúkuài
与[與]	yǔ
羽毛球[羽毛球]	yǔmáoqiú
语法[語法]	yǔfǎ
语言[語言]	yǔyán
预习[預習]	yùxí
原来[原來]	yuánlái
原谅[原諒]	yuánliàng
原因[原因]	yuányīn
约会[約會]	yuēhuì
阅读[閱讀]	yuèdú
云[雲]	yún
允许[允許]	yǔnxǔ
杂志[雜志]	zázhì
咱们[咱們]	zánmen
暂时[暫時]	zànshí
脏[髒]	zāng
责任[責任]	zérèn
增加[增加]	zēngjiā
占线[占線]	zhànxiàn
招聘[招聘]	zhāopìn
照[照]	zhào
真正[真正]	zhēnzhèng
整理[整理]	zhěnglǐ
正常[正常]	zhèngcháng
正好[正好]	zhènghǎo
正确[正確]	zhèngquè
正式[正式]	zhèngshì
证明[證明]	zhèngmíng
之[之]	zhī
支持[支持]	zhīchí
知识[知識]	zhīshi
直接[直接]	zhíjiē
值得[值得]	zhíde
职业[職業]	zhíyè
植物[植物]	zhíwù
只好[只好]	zhǐhǎo
只要[只要]	zhǐyào
指[指]	zhǐ
至少[至少]	zhìshǎo
质量[質量]	zhìliàng
重[重]	zhòng
重点[重點]	zhòngdiǎn
重视[重視]	zhòngshì
周围[周圍]	zhōuwéi
主意[主意]	zhǔyi
祝贺[祝賀]	zhùhè
著名[著名]	zhùmíng
专门[專門]	zhuānmén
专业[專業]	zhuānyè
转[轉]	zhuǎn, zhuàn
赚[賺]	zhuàn
准确[准確]	zhǔnquè
准时[准時]	zhǔnshí
仔细[仔細]	zǐxì
自然[自然]	zìrán
自信[自信]	zìxìn
总结[總結]	zǒngjié
租[租]	zū
最好[最好]	zuìhǎo
尊重[尊重]	zūnzhòng
左右[左右]	zuǒyòu
作家[作家]	zuòjiā
作用[作用]	zuòyòng
作者[作者]	zuòzhě
座[座]	zuò
座位[座位]	zuòwèi

//New HSK (2013)/Level 5
哎[哎]	āi
唉[唉]	ài
爱护[愛護]	àihù
爱惜[愛惜]	àixī
爱心[愛心]	àixīn
安慰[安慰]	ānwèi
安装[安裝]	ānzhuāng
岸[岸]	àn
暗[暗]	àn
熬夜[熬夜]	áoyè
把握[把握]	bǎwò
摆[擺]	bǎi
办理[辦理]	bànlǐ
傍晚[傍晚]	bàngwǎn
包裹[包裹]	bāoguǒ
包含[包含]	bāohán
包括[包括]	bāokuò
薄[薄]	báo
宝贝[寶貝]	bǎobèi
宝贵[寶貴]	bǎoguì
保持[保持]	bǎochí
保存[保存]	bǎocún
保留[保留]	bǎoliú
保险[保險]	bǎoxiǎn
报到[報到]	bàodào
报道[報道]	bàodào
报告[報告]	bàogào
报社[報社]	bàoshè
抱怨[抱怨]	bàoyuàn
背[背]	bēi
悲观[悲觀]	bēiguān
背景[背景]	bèijǐng
被子[被子]	bèizi
本科[本科]	běnkē
本领[本領]	běnlǐng
本质[本質]	běnzhì
比例[比例]	bǐlì
彼此[彼此]	bǐcǐ
必然[必然]	bìrán
必要[必要]	bìyào
毕竟[畢竟]	bìjìng
避免[避免]	bìmiǎn
编辑[編輯]	biānjí
鞭炮[鞭炮]	biānpào
便[便]	biàn, pián
辩论[辯論]	biànlùn
标点[標點]	biāodiǎn
标志[標志]	biāozhì
表达[表達]	biǎodá
表面[表面]	biǎomiàn
表明[表明]	biǎomíng
表情[表情]	biǎoqíng
表现[表現]	biǎoxiàn
冰激凌[冰激淩]	bīngjīlíng
病毒[病毒]	bìngdú
玻璃[玻璃]	bōli
播放[播放]	bōfàng
脖子[脖子]	bózi
博物馆[博物館]	bówùguǎn
补充[補充]	bǔchōng
不安[不安]	bù'ān
不得了[不得了]	bùdéliǎo
不断[不斷]	búduàn
不见得[不見得]	bújiàndé
不耐烦[不耐煩]	búnàifán
不然[不然]	bùrán
不如[不如]	bùrú
不要紧[不要緊]	bú yàojǐn
不足[不足]	bùzú
布[布]	bù
步骤[步驟]	bùzhòu
部门[部門]	bùmén
财产[財産]	cáichǎn
采访[采訪]	cǎifǎng
采取[采取]	cǎiqǔ
彩虹[彩虹]	cǎihóng
踩[踩]	cǎi
参考[參考]	cānkǎo
参与[參與]	cānyù
惭愧[慚愧]	cánkuì
操场[操場]	cāochǎng
操心[操心]	cāo xīn
册[冊]	cè
测验[測驗]	cèyàn
曾经[曾經]	céngjīng
叉子[叉子]	chāzi
差距[差距]	chājù
插[插]	chā
拆[拆]	chāi
产品[産品]	chǎnpǐn
产生[産生]	chǎnshēng
长途[長途]	chángtú
常识[常識]	chángshí
抄[抄]	chāo
超级[超級]	chāojí
朝[朝]	cháo
潮湿[潮濕]	cháoshī
吵[吵]	chǎo
吵架[吵架]	chǎo jià
炒[炒]	chǎo
车库[車庫]	chēkù
车厢[車廂]	chēxiāng
彻底[徹底]	chèdǐ
沉默[沈默]	chénmò
趁[趁]	chèn
称[稱]	chēng
称呼[稱呼]	chēnghu
称赞[稱贊]	chēngzàn
成分[成分]	chéngfèn
成果[成果]	chéngguǒ
成就[成就]	chéngjiù
成立[成立]	chénglì
成人[成人]	chéngrén
成熟[成熟]	chéngshú
成语[成語]	chéngyǔ
成长[成長]	chéngzhǎng
诚恳[誠懇]	chéngkěn
承担[承擔]	chéngdān
承认[承認]	chéngrèn
承受[承受]	chéngshòu
程度[程度]	chéngdù
程序[程序]	chéngxù
吃亏[吃虧]	chīkuī
池塘[池塘]	chítáng
迟早[遲早]	chízǎo
持续[持續]	chíxù
尺子[尺子]	chǐzi
翅膀[翅膀]	chìbǎng
冲[沖]	chōng
充电器[充電器]	chōngdiànqì
充分[充分]	chōngfèn
充满[充滿]	chōngmǎn
重复[重複]	chóngfù
宠物[寵物]	chǒngwù
抽屉[抽屜]	chōuti
抽象[抽象]	chōuxiàng
丑[醜]	chǒu
臭[臭]	chòu
出版[出版]	chūbǎn
出口[出口]	chūkǒu
出色[出色]	chūsè
出示[出示]	chūshì
出席[出席]	chūxí
初级[初級]	chūjí
除非[除非]	chúfēi
除夕[除夕]	chúxī
处理[處理]	chǔlǐ
传播[傳播]	chuánbō
传染[傳染]	chuánrǎn
传说[傳說]	chuánshuō
传统[傳統]	chuántǒng
窗帘[窗簾]	chuānglián
闯[闖]	chuǎng
创造[創造]	chuàngzào
吹[吹]	chuī
词汇[詞彙]	cíhuì
辞职[辭職]	cízhí
此外[此外]	cǐwài
次要[次要]	cìyào
刺激[刺激]	cìjī
匆忙[匆忙]	cōngmáng
从此[從此]	cóngcǐ
从而[從而]	cóng'ér
从前[從前]	cóngqián
从事[從事]	cóngshì
粗糙[粗糙]	cūcāo
促进[促進]	cùjìn
促使[促使]	cùshǐ
醋[醋]	cù
催[催]	cuī
存在[存在]	cúnzài
措施[措施]	cuòshī
答应[答應]	dāying
达到[達到]	dá dào
打工[打工]	dǎgōng
打交道[打交道]	dǎ jiāodao
打喷嚏[打噴嚏]	dǎpēntì
打听[打聽]	dǎting
大方[大方]	dàfang
大厦[大廈]	dàshà
大象[大象]	dàxiàng
大型[大型]	dàxíng
呆[呆]	dāi
代表[代表]	dàibiǎo
代替[代替]	dàitì
贷款[貸款]	dài kuǎn
待遇[待遇]	dàiyù
担任[擔任]	dānrèn
单纯[單純]	dānchún
单调[單調]	dāndiào
单独[單獨]	dāndú
单位[單位]	dānwèi
单元[單元]	dānyuán
耽误[耽誤]	dānwu
胆小鬼[膽小鬼]	dǎnxiǎoguǐ
淡[淡]	dàn
当地[當地]	dāngdì
当心[當心]	dāngxīn
挡[擋]	dǎng
导演[導演]	dǎoyǎn
导致[導致]	dǎozhì
岛屿[島嶼]	dǎoyǔ
倒霉[倒黴]	dǎoméi
到达[到達]	dàodá
道德[道德]	dàodé
道理[道理]	dàolǐ
登记[登記]	dēngjì
等待[等待]	děngdài
等于[等于]	děngyú
滴[滴]	dī
的确[的確]	díquè
敌人[敵人]	dírén
地道[地道]	dìdao
地理[地理]	dìlǐ
地区[地區]	dìqū
地毯[地毯]	dìtǎn
地位[地位]	dìwèi
地震[地震]	dìzhèn
递[遞]	dì
点心[點心]	diǎnxin
电池[電池]	diànchí
电台[電台]	diàntái
钓[釣]	diào
顶[頂]	dǐng
动画片[動畫片]	dònghuàpiàn
冻[凍]	dòng
洞[洞]	dòng
豆腐[豆腐]	dòufu
逗[逗]	dòu
独立[獨立]	dúlì
独特[獨特]	dútè
度过[度過]	dùguò
断[斷]	duàn
堆[堆]	duī
对比[對比]	duìbǐ
对待[對待]	duìdài
对方[對方]	duìfāng
对手[對手]	duìshǒu
对象[對象]	duìxiàng
兑换[兌換]	duìhuàn
吨[噸]	dūn
蹲[蹲]	dūn
顿[頓]	dùn
多亏[多虧]	duōkuī
多余[多余]	duōyú
朵[朵]	duǒ
躲藏[躲藏]	duǒcáng
恶劣[惡劣]	èliè
耳环[耳環]	ěrhuán
发表[發表]	fābiǎo
发愁[發愁]	fā chóu
发达[發達]	fādá
发抖[發抖]	fādǒu
发挥[發揮]	fāhuī
发明[發明]	fāmíng
发票[發票]	fāpiào
发言[發言]	fāyán
罚款[罰款]	fákuǎn
法院[法院]	fǎyuàn
翻[翻]	fān
繁荣[繁榮]	fánróng
反而[反而]	fǎn'ér
反复[反複]	fǎnfù
反应[反應]	fǎnyìng
反映[反映]	fǎnyìng
反正[反正]	fǎnzhèng
范围[範圍]	fànwéi
方[方]	fāng
方案[方案]	fāng'àn
方式[方式]	fāngshì
妨碍[妨礙]	fáng'ài
仿佛[仿佛]	fǎngfú
非[非]	fēi
肥皂[肥皂]	féizào
废话[廢話]	fèihuà
分别[分別]	fēnbié
分布[分布]	fēnbù
分配[分配]	fēnpèi
分手[分手]	fēnshǒu
分析[分析]	fēnxī
纷纷[紛紛]	fēnfēn
奋斗[奮鬥]	fèndòu
风格[風格]	fēnggé
风景[風景]	fēngjǐng
风俗[風俗]	fēngsú
风险[風險]	fēngxiǎn
疯狂[瘋狂]	fēngkuáng
讽刺[諷刺]	fěngcì
否定[否定]	fǒudìng
否认[否認]	fǒurèn
扶[扶]	fú
服装[服裝]	fúzhuāng
幅[幅]	fú
辅导[輔導]	fǔdǎo
妇女[婦女]	fùnǚ
复制[複制]	fùzhì
改革[改革]	gǎigé
改进[改進]	gǎijìn
改善[改善]	gǎishàn
改正[改正]	gǎizhèng
盖[蓋]	gài
概括[概括]	gàikuò
概念[概念]	gàiniàn
干脆[幹脆]	gāncuì
干燥[幹燥]	gānzào
赶紧[趕緊]	gǎnjǐn
赶快[趕快]	gǎnkuài
感激[感激]	gǎnjī
感受[感受]	gǎnshòu
感想[感想]	gǎnxiǎng
干活儿[幹活兒]	gàn huór
钢铁[鋼鐵]	gāngtiě
高档[高檔]	gāodàng
高级[高級]	gāojí
搞[搞]	gǎo
告别[告別]	gàobié
格外[格外]	géwài
隔壁[隔壁]	gébì
个别[個別]	gèbié
个人[個人]	gèrén
个性[個性]	gèxìng
各自[各自]	gèzì
根[根]	gēn
根本[根本]	gēnběn
工厂[工廠]	gōngchǎng
工程师[工程師]	gōngchéngshī
工具[工具]	gōngjù
工人[工人]	gōngrén
工业[工業]	gōngyè
公布[公布]	gōngbù
公开[公開]	gōngkāi
公平[公平]	gōngpíng
公寓[公寓]	gōngyù
公元[公元]	gōngyuán
公主[公主]	gōngzhǔ
功能[功能]	gōngnéng
恭喜[恭喜]	gōngxǐ
贡献[貢獻]	gòngxiàn
沟通[溝通]	gōutōng
构成[構成]	gòuchéng
姑姑[姑姑]	gūgu
姑娘[姑娘]	gūniang
古代[古代]	gǔdài
古典[古典]	gǔdiǎn
股票[股票]	gǔpiào
骨头[骨頭]	gǔtou
鼓舞[鼓舞]	gǔwǔ
鼓掌[鼓掌]	gǔ zhǎng
固定[固定]	gùdìng
挂号[挂號]	guà hào
乖[乖]	guāi
拐弯[拐彎]	guǎi wān
怪不得[怪不得]	guài bu de
关闭[關閉]	guānbì
观察[觀察]	guānchá
观点[觀點]	guāndiǎn
观念[觀念]	guānniàn
官[官]	guān
管子[管子]	guǎnzi
冠军[冠軍]	guànjūn
光滑[光滑]	guānghuá
光临[光臨]	guānglín
光明[光明]	guāngmíng
光盘[光盤]	guāngpán
广场[廣場]	guǎngchǎng
广大[廣大]	guǎngdà
广泛[廣泛]	guǎngfàn
归纳[歸納]	guīnà
规矩[規矩]	guīju
规律[規律]	guīlǜ
规模[規模]	guīmó
规则[規則]	guīzé
柜台[櫃台]	guìtái
滚[滾]	gǔn
锅[鍋]	guō
国庆节[國慶節]	Guóqìng Jié
国王[國王]	guówáng
果然[果然]	guǒrán
果实[果實]	guǒshí
过分[過分]	guòfèn
过敏[過敏]	guòmǐn
过期[過期]	guòqī
哈[哈]	hā
海关[海關]	hǎiguān
海鲜[海鮮]	hǎixiān
喊[喊]	hǎn
行业[行業]	hángyè
豪华[豪華]	háohuá
好客[好客]	hàokè
好奇[好奇]	hàoqí
合法[合法]	héfǎ
合理[合理]	hélǐ
合同[合同]	hétong
合影[合影]	héyǐng
合作[合作]	hézuò
何必[何必]	hébì
何况[何況]	hékuàng
和平[和平]	hépíng
核心[核心]	héxīn
恨[恨]	hèn
猴子[猴子]	hóuzi
后背[後背]	hòubèi
后果[後果]	hòuguǒ
呼吸[呼吸]	hūxī
忽然[忽然]	hūrán
忽视[忽視]	hūshì
胡说[胡說]	húshuō
胡同[胡同]	hútòng
壶[壺]	hú
蝴蝶[蝴蝶]	húdié
糊涂[糊塗]	hútu
花生[花生]	huāshēng
划[劃]	huà, huá
华裔[華裔]	Huáyì
滑[滑]	huá
化学[化學]	huàxué
话题[話題]	huàtí
怀念[懷念]	huáiniàn
怀孕[懷孕]	huáiyùn
缓解[緩解]	huǎnjiě
幻想[幻想]	huànxiǎng
慌张[慌張]	huāngzhāng
黄金[黃金]	huángjīn
灰[灰]	huī
灰尘[灰塵]	huīchén
灰心[灰心]	huī xīn
挥[揮]	huī
恢复[恢複]	huīfù
汇率[彙率]	huìlǜ
婚礼[婚禮]	hūnlǐ
婚姻[婚姻]	hūnyīn
活跃[活躍]	huóyuè
火柴[火柴]	huǒchái
伙伴[夥伴]	huǒbàn
或许[或許]	huòxǔ
机器[機器]	jīqì
肌肉[肌肉]	jīròu
基本[基本]	jīběn
激烈[激烈]	jīliè
及格[及格]	jí gé
极其[極其]	jíqí
急忙[急忙]	jímáng
急诊[急診]	jízhěn
集合[集合]	jíhé
集体[集體]	jítǐ
集中[集中]	jízhōng
计算[計算]	jìsuàn
记录[記錄]	jìlù
记忆[記憶]	jìyì
纪录[紀錄]	jìlù
纪律[紀律]	jìlǜ
纪念[紀念]	jìniàn
系领带[系領帶]	jìlǐngdài
寂寞[寂寞]	jìmò
夹子[夾子]	jiāzi
家庭[家庭]	jiātíng
家务[家務]	jiāwù
家乡[家鄉]	jiāxiāng
嘉宾[嘉賓]	jiābīn
甲[甲]	jiǎ
假如[假如]	jiǎrú
假设[假設]	jiǎshè
假装[假裝]	jiǎzhuāng
价值[價值]	jiàzhí
驾驶[駕駛]	jiàshǐ
嫁[嫁]	jià
坚决[堅決]	jiānjué
坚强[堅強]	jiānqiáng
肩膀[肩膀]	jiānbǎng
艰巨[艱巨]	jiānjù
艰苦[艱苦]	jiānkǔ
兼职[兼職]	jiānzhí
捡[撿]	jiǎn
剪刀[剪刀]	jiǎndāo
简历[簡曆]	jiǎnlì
简直[簡直]	jiǎnzhí
建立[建立]	jiànlì
建设[建設]	jiànshè
建筑[建築]	jiànzhù
健身[健身]	jiànshēn
键盘[鍵盤]	jiànpán
讲究[講究]	jiǎngjiu
讲座[講座]	jiǎngzuò
酱油[醬油]	jiàngyóu
交换[交換]	jiāohuàn
交际[交際]	jiāojì
交往[交往]	jiāowǎng
浇[澆]	jiāo
胶水[膠水]	jiāoshuǐ
角度[角度]	jiǎodù
狡猾[狡猾]	jiǎohuá
教材[教材]	jiàocái
教练[教練]	jiàoliàn
教训[教訓]	jiàoxun
阶段[階段]	jiēduàn
结实[結實]	jiēshi
接触[接觸]	jiēchù
接待[接待]	jiēdài
接近[接近]	jiējìn
节省[節省]	jiéshěng
结构[結構]	jiégòu
结合[結合]	jiéhé
结论[結論]	jiélùn
结账[結賬]	jiézhàng
戒[戒]	jiè
戒指[戒指]	jièzhi
届[屆]	jiè
借口[借口]	jièkǒu
金属[金屬]	jīnshǔ
尽快[盡快]	jǐnkuài
尽量[盡量]	jǐnliàng
紧急[緊急]	jǐnjí
谨慎[謹慎]	jǐnshèn
尽力[盡力]	jìn lì
进步[進步]	jìnbù
进口[進口]	jìn kǒu
近代[近代]	jìndài
经典[經典]	jīngdiǎn
经商[經商]	jīng shāng
经营[經營]	jīngyíng
精力[精力]	jīnglì
精神[精神]	jīngshen
酒吧[酒吧]	jiǔbā
救[救]	jiù
救护车[救護車]	jiùhùchē
舅舅[舅舅]	jiùjiu
居然[居然]	jūrán
桔子[桔子]	júzi
巨大[巨大]	jùdà
具备[具備]	jùbèi
具体[具體]	jùtǐ
俱乐部[俱樂部]	jùlèbù
据说[據說]	jùshuō
捐[捐]	juān
决赛[決賽]	juésài
决心[決心]	juéxīn
角色[角色]	juésè
绝对[絕對]	juéduì
军事[軍事]	jūnshì
均匀[均勻]	jūnyún
卡车[卡車]	kǎchē
开发[開發]	kāifā
开放[開放]	kāifàng
开幕式[開幕式]	kāimùshì
开水[開水]	kāishuǐ
砍[砍]	kǎn
看不起[看不起]	kàn bu qǐ
看望[看望]	kànwàng
靠[靠]	kào
颗[顆]	kē
可见[可見]	kějiàn
可靠[可靠]	kěkào
可怕[可怕]	kěpà
克[克]	kè
克服[克服]	kèfú
刻苦[刻苦]	kèkǔ
客观[客觀]	kèguān
课程[課程]	kèchéng
空间[空間]	kōngjiān
空闲[空閑]	kòngxián
控制[控制]	kòngzhì
口味[口味]	kǒuwèi
夸[誇]	kuā
夸张[誇張]	kuāzhāng
会计[會計]	kuàijì
宽[寬]	kuān
昆虫[昆蟲]	kūnchóng
扩大[擴大]	kuòdà
辣椒[辣椒]	làjiāo
拦[攔]	lán
烂[爛]	làn
朗读[朗讀]	lǎngdú
劳动[勞動]	láodòng
劳驾[勞駕]	láo jià
老百姓[老百姓]	lǎobǎixìng
老板[老板]	lǎobǎn
老婆[老婆]	lǎopó
老实[老實]	lǎoshi
老鼠[老鼠]	lǎoshǔ
姥姥[姥姥]	lǎolao
乐观[樂觀]	lèguān
雷[雷]	léi
类型[類型]	lèixíng
冷淡[冷淡]	lěngdàn
厘米[厘米]	límǐ
离婚[離婚]	lí hūn
梨[梨]	lí
理论[理論]	lǐlùn
理由[理由]	lǐyóu
力量[力量]	lìliang
立即[立即]	lìjí
立刻[立刻]	lìkè
利润[利潤]	lìrùn
利息[利息]	lìxī
利益[利益]	lìyì
利用[利用]	lìyòng
连忙[連忙]	liánmáng
连续[連續]	liánxù
联合[聯合]	liánhé
恋爱[戀愛]	liàn'ài
良好[良好]	liánghǎo
粮食[糧食]	liángshi
亮[亮]	liàng
了不起[了不起]	liǎobuqǐ
列车[列車]	lièchē
临时[臨時]	línshí
灵活[靈活]	línghuó
铃[鈴]	líng
零件[零件]	língjiàn
零食[零食]	língshí
领导[領導]	lǐngdǎo
领域[領域]	lǐngyù
浏览[浏覽]	liúlǎn
流传[流傳]	liúchuán
流泪[流淚]	liúlèi
龙[龍]	lóng
漏[漏]	lòu
陆地[陸地]	lùdì
陆续[陸續]	lùxù
录取[錄取]	lùqǔ
录音[錄音]	lùyīn
轮流[輪流]	lúnliú
论文[論文]	lùnwén
逻辑[邏輯]	luóji
落后[落後]	luòhòu
骂[罵]	mà
麦克风[麥克風]	màikèfēng
馒头[饅頭]	mántou
满足[滿足]	mǎnzú
毛病[毛病]	máobìng
矛盾[矛盾]	máodùn
冒险[冒險]	màoxiǎn
贸易[貿易]	màoyì
眉毛[眉毛]	méimao
媒体[媒體]	méitǐ
煤炭[煤炭]	méitàn
美术[美術]	měishù
魅力[魅力]	mèilì
梦想[夢想]	mèngxiǎng
秘密[秘密]	mìmì
秘书[秘書]	mìshu
密切[密切]	mìqiè
蜜蜂[蜜蜂]	mìfēng
面对[面對]	miànduì
面积[面積]	miànjī
面临[面臨]	miànlín
苗条[苗條]	miáotiao
描写[描寫]	miáoxiě
敏感[敏感]	mǐngǎn
名牌[名牌]	míngpái
名片[名片]	míngpiàn
名胜古迹[名勝古迹]	míngshènggǔjì
明确[明確]	míngquè
明显[明顯]	míngxiǎn
明星[明星]	míngxīng
命令[命令]	mìnglìng
命运[命運]	mìngyùn
摸[摸]	mō
模仿[模仿]	mófǎng
模糊[模糊]	móhu
模特[模特]	mótè
摩托车[摩托車]	mótuōchē
陌生[陌生]	mòshēng
某[某]	mǒu
木头[木頭]	mùtou
目标[目標]	mùbiāo
目录[目錄]	mùlù
目前[目前]	mùqián
哪怕[哪怕]	nǎpà
难怪[難怪]	nánguài
难免[難免]	nánmiǎn
脑袋[腦袋]	nǎodai
内部[內部]	nèibù
内科[內科]	nèikē
嫩[嫩]	nèn
能干[能幹]	nénggàn
能源[能源]	néngyuán
嗯[嗯]	ēn
年代[年代]	niándài
年纪[年紀]	niánjì
念[念]	niàn
宁可[甯可]	nìngkě
牛仔裤[牛仔褲]	niúzǎikù
农村[農村]	nóngcūn
农民[農民]	nóngmín
农业[農業]	nóngyè
浓[濃]	nóng
女士[女士]	nǚshì
欧洲[歐洲]	Ōuzhōu
偶然[偶然]	ǒurán
拍[拍]	pāi
派[派]	pài
盼望[盼望]	pànwàng
培训[培訓]	péixùn
培养[培養]	péiyǎng
赔偿[賠償]	péicháng
佩服[佩服]	pèifu
配合[配合]	pèihé
盆[盆]	pén
碰[碰]	pèng
批[批]	pī
批准[批准]	pīzhǔn
披[披]	pī
疲劳[疲勞]	píláo
匹[匹]	pǐ
片[片]	piàn, piān
片面[片面]	piànmiàn
飘[飄]	piāo
拼音[拼音]	pīnyīn
频道[頻道]	píndào
平[平]	píng
平安[平安]	píng'ān
平常[平常]	píngcháng
平等[平等]	píngděng
平方[平方]	píngfāng
平衡[平衡]	pínghéng
平静[平靜]	píngjìng
平均[平均]	píngjūn
评价[評價]	píngjià
凭[憑]	píng
迫切[迫切]	pòqiè
破产[破産]	pò chǎn
破坏[破壞]	pòhuài
期待[期待]	qīdài
期间[期間]	qījiān
其余[其余]	qíyú
奇迹[奇迹]	qíjì
企业[企業]	qǐyè
启发[啓發]	qǐfā
气氛[氣氛]	qìfēn
汽油[汽油]	qìyóu
谦虚[謙虛]	qiānxū
签[簽]	qiān
前途[前途]	qiántú
浅[淺]	qiǎn
欠[欠]	qiàn
枪[槍]	qiāng
强调[強調]	qiángdiào
强烈[強烈]	qiángliè
墙[牆]	qiáng
抢[搶]	qiǎng, qiāng
悄悄[悄悄]	qiāoqiāo
瞧[瞧]	qiáo
巧妙[巧妙]	qiǎomiào
切[切]	qiē, qiè
亲爱[親愛]	qīn'ài
亲切[親切]	qīnqiè
亲自[親自]	qīnzì
勤奋[勤奮]	qínfèn
青[青]	qīng
青春[青春]	qīngchūn
青少年[青少年]	qīngshàonián
轻视[輕視]	qīngshì
轻易[輕易]	qīngyì
清淡[清淡]	qīngdàn
情景[情景]	qíngjǐng
情绪[情緒]	qíngxù
请求[請求]	qǐngqiú
庆祝[慶祝]	qìngzhù
球迷[球迷]	qiúmí
趋势[趨勢]	qūshì
取消[取消]	qǔxiāo
娶[娶]	qǔ
去世[去世]	qùshì
圈[圈]	quān
权力[權力]	quánlì
权利[權利]	quánlì
全面[全面]	quánmiàn
劝[勸]	quàn
缺乏[缺乏]	quēfá
确定[確定]	quèdìng
确认[確認]	quèrèn
群[群]	qún
燃烧[燃燒]	ránshāo
绕[繞]	rào
热爱[熱愛]	rè'ài
热烈[熱烈]	rèliè
热心[熱心]	rèxīn
人才[人才]	réncái
人口[人口]	rénkǒu
人类[人類]	rénlèi
人民币[人民幣]	rénmínbì
人生[人生]	rénshēng
人事[人事]	rénshì
人物[人物]	rénwù
人员[人員]	rényuán
忍不住[忍不住]	rěn bu zhù
日常[日常]	rìcháng
日程[日程]	rìchéng
日历[日曆]	rìlì
日期[日期]	rìqī
日用品[日用品]	rìyòngpǐn
日子[日子]	rìzi
如何[如何]	rúhé
如今[如今]	rújīn
软[軟]	ruǎn
软件[軟件]	ruǎnjiàn
弱[弱]	ruò
洒[灑]	sǎ
嗓子[嗓子]	sǎngzi
色彩[色彩]	sècǎi
杀[殺]	shā
沙漠[沙漠]	shāmò
沙滩[沙灘]	shātān
傻[傻]	shǎ
晒[曬]	shài
删除[刪除]	shānchú
闪电[閃電]	shǎndiàn
扇子[扇子]	shànzi
善良[善良]	shànliáng
善于[善于]	shànyú
伤害[傷害]	shānghài
商品[商品]	shāngpǐn
商务[商務]	shāngwù
商业[商業]	shāngyè
上当[上當]	shàng dàng
蛇[蛇]	shé
舍不得[舍不得]	shěbude
设备[設備]	shèbèi
设计[設計]	shèjì
设施[設施]	shèshī
射击[射擊]	shèjī
摄影[攝影]	shè yǐng
伸[伸]	shēn
身材[身材]	shēncái
身份[身份]	shēnfèn
深刻[深刻]	shēnkè
神话[神話]	shénhuà
神秘[神秘]	shénmì
升[升]	shēng
生产[生産]	shēngchǎn
生动[生動]	shēngdòng
生长[生長]	shēngzhǎng
声调[聲調]	shēngdiào
绳子[繩子]	shéngzi
省略[省略]	shěnglüè
胜利[勝利]	shènglì
失眠[失眠]	shīmián
失去[失去]	shīqù
失业[失業]	shī yè
诗[詩]	shī
狮子[獅子]	shīzi
湿润[濕潤]	shīrùn
石头[石頭]	shítou
时差[時差]	shíchā
时代[時代]	shídài
时刻[時刻]	shíkè
时髦[時髦]	shímáo
时期[時期]	shíqī
时尚[時尚]	shíshàng
实话[實話]	shíhuà
实践[實踐]	shíjiàn
实习[實習]	shíxí
实现[實現]	shíxiàn
实验[實驗]	shíyàn
实用[實用]	shíyòng
食物[食物]	shíwù
使劲儿[使勁兒]	shǐjìnr
始终[始終]	shǐzhōng
士兵[士兵]	shìbīng
市场[市場]	shìchǎng
似的[似的]	shìde
事实[事實]	shìshí
事物[事物]	shìwù
事先[事先]	shìxiān
试卷[試卷]	shìjuàn
收获[收獲]	shōuhuò
收据[收據]	shōujù
手工[手工]	shǒugōng
手术[手術]	shǒushù
手套[手套]	shǒutào
手续[手續]	shǒuxù
手指[手指]	shǒuzhǐ
首[首]	shǒu
寿命[壽命]	shòumìng
受伤[受傷]	shòu shāng
书架[書架]	shūjià
梳子[梳子]	shūzi
舒适[舒適]	shūshì
输入[輸入]	shūrù
蔬菜[蔬菜]	shūcài
熟练[熟練]	shúliàn
属于[屬于]	shǔyú
鼠标[鼠標]	shǔ biāo
数[數]	shù, shǔ
数据[數據]	shùjù
数码[數碼]	shùmǎ
摔倒[摔倒]	shuāidǎo
甩[甩]	shuǎi
双方[雙方]	shuāngfāng
税[稅]	shuì
说不定[說不定]	shuōbudìng
说服[說服]	shuō fú
丝绸[絲綢]	sīchóu
丝毫[絲毫]	sīháo
私人[私人]	sīrén
思考[思考]	sīkǎo
思想[思想]	sīxiǎng
撕[撕]	sī
似乎[似乎]	sìhū
搜索[搜索]	sōusuǒ
宿舍[宿舍]	sùshè
随身[隨身]	suíshēn
随时[隨時]	suíshí
随手[隨手]	suíshǒu
碎[碎]	suì
损失[損失]	sǔnshī
缩短[縮短]	suōduǎn
所[所]	suǒ
锁[鎖]	suǒ
台阶[台階]	táijiē
太极拳[太極拳]	tàijíquán
太太[太太]	tàitai
谈判[談判]	tánpàn
坦率[坦率]	tǎnshuài
烫[燙]	tàng
逃[逃]	táo
逃避[逃避]	táobì
桃[桃]	táo
淘气[淘氣]	táoqì
讨价还价[討價還價]	tǎo jià huán jià
套[套]	tào
特色[特色]	tèsè
特殊[特殊]	tèshū
特征[特征]	tèzhēng
疼爱[疼愛]	téng ài
提倡[提倡]	tíchàng
提纲[提綱]	tígāng
提问[提問]	tíwèn
题目[題目]	tímù
体会[體會]	tǐhuì
体贴[體貼]	tǐtiē
体现[體現]	tǐxiàn
体验[體驗]	tǐyàn
天空[天空]	tiānkōng
天真[天真]	tiānzhēn
调皮[調皮]	tiáopí
调整[調整]	tiáozhěng
挑战[挑戰]	tiǎozhàn
通常[通常]	tōngcháng
统一[統一]	tǒngyī
痛苦[痛苦]	tòngkǔ
痛快[痛快]	tòngkuai
偷[偷]	tōu
投入[投入]	tóurù
投资[投資]	tóu zī
透明[透明]	tòumíng
突出[突出]	tūchū
土地[土地]	tǔdì
土豆[土豆]	tǔdòu
吐[吐]	tǔ, tù
兔子[兔子]	tùzi
团[團]	tuán
推辞[推辭]	tuīcí
推广[推廣]	tuīguǎng
推荐[推薦]	tuījiàn
退[退]	tuì
退步[退步]	tuìbù
退休[退休]	tuìxiū
歪[歪]	wāi
外公[外公]	wàigōng
外交[外交]	wàijiāo
完美[完美]	wánměi
完善[完善]	wánshàn
完整[完整]	wánzhěng
玩具[玩具]	wánjù
万一[萬一]	wànyī
王子[王子]	wángzǐ
网络[網絡]	wǎngluò
往返[往返]	wǎngfǎn
危害[危害]	wēihài
威胁[威脅]	wēixié
微笑[微笑]	wēixiào
违反[違反]	wéifǎn
围巾[圍巾]	wéijīn
围绕[圍繞]	wéirào
唯一[唯一]	wéiyī
维修[維修]	wéixiū
伟大[偉大]	wěidà
尾巴[尾巴]	wěiba
委屈[委屈]	wěiqu
未必[未必]	wèibì
未来[未來]	wèilái
位于[位于]	wèiyú
位置[位置]	wèizhi
胃[胃]	wèi
胃口[胃口]	wèikǒu
温暖[溫暖]	wēnnuǎn
温柔[溫柔]	wēnróu
文件[文件]	wénjiàn
文具[文具]	wénjù
文明[文明]	wénmíng
文学[文學]	wénxué
文字[文字]	wénzì
闻[聞]	wén
吻[吻]	wěn
稳定[穩定]	wěndìng
问候[問候]	wènhòu
卧室[臥室]	wòshì
握手[握手]	wò shǒu
屋子[屋子]	wūzi
无奈[無奈]	wúnài
无数[無數]	wúshù
无所谓[無所謂]	wúsuǒwèi
武术[武術]	wǔshù
勿[勿]	wù
物理[物理]	wùlǐ
物质[物質]	wùzhì
雾[霧]	wù
吸取[吸取]	xīqǔ
吸收[吸收]	xīshōu
戏剧[戲劇]	xìjù
系[系]	xì, jì
系统[系統]	xìtǒng
细节[細節]	xìjié
瞎[瞎]	xiā
下载[下載]	xiàzǎi
吓[嚇]	xià
夏令营[夏令營]	xiàlìngyíng
鲜艳[鮮豔]	xiānyàn
显得[顯得]	xiǎnde
显然[顯然]	xiǎnrán
显示[顯示]	xiǎnshì
县[縣]	xiàn
现代[現代]	xiàndài
现实[現實]	xiànshí
现象[現象]	xiànxiàng
限制[限制]	xiànzhì
相处[相處]	xiāngchǔ
相当[相當]	xiāngdāng
相对[相對]	xiāngduì
相关[相關]	xiāngguān
相似[相似]	xiāngsì
香肠[香腸]	xiāngcháng
享受[享受]	xiǎngshòu
想念[想念]	xiǎngniàn
想象[想象]	xiǎngxiàng
项[項]	xiàng
项链[項鏈]	xiàngliàn
项目[項目]	xiàngmù
象棋[象棋]	xiàngqí
象征[象征]	xiàngzhēng
消费[消費]	xiāofèi
消化[消化]	xiāohuà
消极[消極]	xiāojí
消失[消失]	xiāoshī
销售[銷售]	xiāoshòu
小麦[小麥]	xiǎomài
小气[小氣]	xiǎoqì
孝顺[孝順]	xiàoshùn
效率[效率]	xiàolǜ
歇[歇]	xiē
斜[斜]	xié
写作[寫作]	xiězuò
血[血]	xuè
心理[心理]	xīnlǐ
心脏[心髒]	xīnzàng
欣赏[欣賞]	xīnshǎng
信号[信號]	xìnhào
信任[信任]	xìnrèn
行动[行動]	xíngdòng
行人[行人]	xíngrén
行为[行爲]	xíngwéi
形成[形成]	xíngchéng
形容[形容]	xíngróng
形式[形式]	xíngshì
形势[形勢]	xíngshì
形象[形象]	xíngxiàng
形状[形狀]	xíngzhuàng
幸亏[幸虧]	xìngkuī
幸运[幸運]	xìngyùn
性质[性質]	xìngzhì
兄弟[兄弟]	xiōngdì
胸[胸]	xiōng
休闲[休閑]	xiūxián
修改[修改]	xiūgǎi
虚心[虛心]	xūxīn
叙述[敘述]	xùshù
宣布[宣布]	xuānbù
宣传[宣傳]	xuānchuán
学历[學曆]	xuélì
学术[學術]	xuéshù
学问[學問]	xuéwen
寻找[尋找]	xúnzhǎo
询问[詢問]	xúnwèn
训练[訓練]	xùnliàn
迅速[迅速]	xùnsù
押金[押金]	yājīn
牙齿[牙齒]	yáchǐ
延长[延長]	yáncháng
严肃[嚴肅]	yánsù
演讲[演講]	yǎnjiǎng
宴会[宴會]	yànhuì
阳台[陽台]	yángtái
痒[癢]	yǎng
样式[樣式]	yàngshì
腰[腰]	yāo
摇[搖]	yáo
咬[咬]	yǎo
要不[要不]	yàobù
业务[業務]	yèwù
业余[業余]	yèyú
夜[夜]	yè
一辈子[一輩子]	yíbèizi
一旦[一旦]	yídàn
一律[一律]	yílǜ
一再[一再]	yízài
一致[一致]	yízhì
依然[依然]	yīrán
移动[移動]	yídòng
移民[移民]	yímín
遗憾[遺憾]	yíhàn
疑问[疑問]	yíwèn
乙[乙]	yǐ
以及[以及]	yǐjí
以来[以來]	yǐlái
亿[億]	yì
义务[義務]	yìwù
议论[議論]	yìlùn
意外[意外]	yìwài
意义[意義]	yìyì
因而[因而]	yīn'ér
因素[因素]	yīnsù
银[銀]	yín
印刷[印刷]	yìnshuā
英俊[英俊]	yīngjùn
英雄[英雄]	yīngxióng
迎接[迎接]	yíngjiē
营养[營養]	yíngyǎng
营业[營業]	yíngyè
影子[影子]	yǐngzi
应付[應付]	yìngfu
应用[應用]	yìngyòng
硬[硬]	yìng
硬件[硬件]	yìngjiàn
拥抱[擁抱]	yōngbào
拥挤[擁擠]	yōngjǐ
勇气[勇氣]	yǒngqì
用功[用功]	yòng gōng
用途[用途]	yòngtú
优惠[優惠]	yōuhuì
优美[優美]	yōuměi
优势[優勢]	yōushì
悠久[悠久]	yōujiǔ
犹豫[猶豫]	yóuyù
油炸[油炸]	yóuzhá
游览[遊覽]	yóulǎn
有利[有利]	yǒulì
幼儿园[幼兒園]	yòu'éryuán
娱乐[娛樂]	yúlè
与其[與其]	yǔqí
语气[語氣]	yǔqì
玉米[玉米]	yùmǐ
预报[預報]	yùbào
预订[預訂]	yùdìng
预防[預防]	yùfáng
元旦[元旦]	yuándàn
员工[員工]	yuángōng
原料[原料]	yuánliào
原则[原則]	yuánzé
圆[圓]	yuán
愿望[願望]	yuànwàng
乐器[樂器]	yuèqì
晕[暈]	yūn
运气[運氣]	yùnqi
运输[運輸]	yùnshū
运用[運用]	yùnyòng
灾害[災害]	zāihài
再三[再三]	zàisān
在乎[在乎]	zàihu
在于[在于]	zàiyú
赞成[贊成]	zànchéng
赞美[贊美]	zànměi
糟糕[糟糕]	zāogāo
造成[造成]	zàochéng
则[則]	zé
责备[責備]	zébèi
摘[摘]	zhāi
窄[窄]	zhǎi
粘贴[粘貼]	zhāntiē
展开[展開]	zhǎn kāi
展览[展覽]	zhǎnlǎn
占[占]	zhàn
战争[戰爭]	zhànzhēng
长辈[長輩]	zhǎngbèi
涨[漲]	zhǎng, zhàng
掌握[掌握]	zhǎngwò
账户[賬戶]	zhànghù
招待[招待]	zhāodài
着火[著火]	zháohuǒ
着凉[著涼]	zháo liáng
召开[召開]	zhàokāi
照常[照常]	zhàocháng
哲学[哲學]	zhéxué
针对[針對]	zhēnduì
珍惜[珍惜]	zhēnxī
真实[真實]	zhēnshí
诊断[診斷]	zhěnduàn
阵[陣]	zhèn
振动[振動]	zhèndòng
争论[爭論]	zhēnglùn
争取[爭取]	zhēngqǔ
征求[征求]	zhēngqiú
睁[睜]	zhēng
整个[整個]	zhěnggè
整齐[整齊]	zhěngqí
整体[整體]	zhěngtǐ
正[正]	zhèng
证件[證件]	zhèngjiàn
证据[證據]	zhèngjù
政府[政府]	zhèngfǔ
政治[政治]	zhèngzhì
挣[掙]	zhèng, zhēng
支[支]	zhī
支票[支票]	zhīpiào
执照[執照]	zhízhào
直[直]	zhí
指导[指導]	zhǐdǎo
指挥[指揮]	zhǐhuī
至今[至今]	zhì jīn
至于[至于]	zhìyú
志愿者[志願者]	zhìyuànzhě
制定[制定]	zhìdìng
制度[制度]	zhìdù
制造[制造]	zhìzào
制作[制作]	zhìzuò
治疗[治療]	zhìliáo
秩序[秩序]	zhìxù
智慧[智慧]	zhìhuì
中介[中介]	zhōngjiè
中心[中心]	zhōngxīn
中旬[中旬]	zhōngxún
种类[種類]	zhǒnglèi
重大[重大]	zhòngdà
重量[重量]	zhòngliàng
周到[周到]	zhōudào
猪[豬]	zhū
竹子[竹子]	zhúzi
逐步[逐步]	zhúbù
逐渐[逐漸]	zhújiàn
主持[主持]	zhǔchí
主动[主動]	zhǔdòng
主观[主觀]	zhǔguān
主人[主人]	zhǔrén
主任[主任]	zhǔrèn
主题[主題]	zhǔtí
主席[主席]	zhǔxí
主张[主張]	zhǔzhāng
煮[煮]	zhǔ
注册[注冊]	zhùcè
祝福[祝福]	zhùfú
抓[抓]	zhuā
抓紧[抓緊]	zhuā jǐn
专家[專家]	zhuānjiā
专心[專心]	zhuānxīn
转变[轉變]	zhuǎnbiàn
转告[轉告]	zhuǎngào
装[裝]	zhuāng
装饰[裝飾]	zhuāngshì
装修[裝修]	zhuāngxiū
状况[狀況]	zhuàngkuàng
状态[狀態]	zhuàngtài
撞[撞]	zhuàng
追[追]	zhuī
追求[追求]	zhuīqiú
咨询[咨詢]	zīxún
姿势[姿勢]	zīshì
资格[資格]	zīgé
资金[資金]	zījīn
资料[資料]	zīliào
资源[資源]	zīyuán
紫[紫]	zǐ
自从[自從]	zìcóng
自动[自動]	zìdòng
自豪[自豪]	zìháo
自觉[自覺]	zìjué
自私[自私]	zìsī
自由[自由]	zìyóu
自愿[自願]	zìyuàn
字母[字母]	zìmǔ
字幕[字幕]	zìmù
综合[綜合]	zōnghé
总裁[總裁]	zǒngcái
总共[總共]	zǒnggòng
总理[總理]	zǒnglǐ
总算[總算]	zǒngsuàn
总统[總統]	zǒngtǒng
总之[總之]	zǒngzhī
阻止[阻止]	zǔzhǐ
组[組]	zǔ
组成[組成]	zǔchéng
组合[組合]	zǔhé
组织[組織]	zǔzhī
最初[最初]	zuìchū
醉[醉]	zuì
尊敬[尊敬]	zūnjìng
遵守[遵守]	zūnshǒu
作品[作品]	zuòpǐn
作为[作爲]	zuòwéi
作文[作文]	zuò wén

//New HSK (2013)/Level 6
挨[挨]	āi
癌症[癌症]	áizhèng
爱不释手[愛不釋手]	àibúshìshǒu
爱戴[愛戴]	àidài
暧昧[暧昧]	àimèi
安宁[安甯]	ānníng
安详[安詳]	ānxiáng
安置[安置]	ānzhì
按摩[按摩]	ànmó
案件[案件]	ànjiàn
案例[案例]	ànlì
暗示[暗示]	ànshì
昂贵[昂貴]	ángguì
凹凸[凹凸]	āotū
熬[熬]	áo
奥秘[奧秘]	àomì
巴不得[巴不得]	bābùdé
巴结[巴結]	bājie
扒[扒]	bā
疤[疤]	bā
拔苗助长[拔苗助長]	bámiáozhùzhǎng
把关[把關]	bǎ guān
把手[把手]	bǎshou
罢工[罷工]	bà gōng
霸道[霸道]	bàdào
掰[掰]	bāi
摆脱[擺脫]	bǎituō
败坏[敗壞]	bàihuài
拜访[拜訪]	bàifǎng
拜年[拜年]	bài nián
拜托[拜托]	bàituō
颁布[頒布]	bānbù
颁发[頒發]	bānfā
斑[斑]	bān
版本[版本]	bǎnběn
半途而废[半途而廢]	bàn tú ér fèi
扮演[扮演]	bànyǎn
伴侣[伴侶]	bànlǚ
伴随[伴隨]	bànsuí
绑架[綁架]	bǎngjià
榜样[榜樣]	bǎngyàng
磅[磅]	bàng
包庇[包庇]	bāobì
包袱[包袱]	bāofu
包围[包圍]	bāowéi
包装[包裝]	bāozhuāng
饱和[飽和]	bǎohé
饱经沧桑[飽經滄桑]	bǎojīngcāngsāng
保管[保管]	bǎoguǎn
保密[保密]	bǎo mì
保姆[保姆]	bǎomǔ
保守[保守]	bǎoshǒu
保卫[保衛]	bǎowèi
保养[保養]	bǎoyǎng
保障[保障]	bǎozhàng
保重[保重]	bǎozhòng
报仇[報仇]	bàochóu
报酬[報酬]	bàochou
报答[報答]	bàodá
报复[報複]	bàofu
报警[報警]	bàojǐng
报销[報銷]	bàoxiāo
抱负[抱負]	bàofù
暴力[暴力]	bàolì
暴露[暴露]	bàolù
曝光[曝光]	bàoguāng
爆发[爆發]	bàofā
爆炸[爆炸]	bàozhà
卑鄙[卑鄙]	bēibǐ
悲哀[悲哀]	bēi'āi
悲惨[悲慘]	bēicǎn
北极[北極]	běijí
贝壳[貝殼]	bèiké
备份[備份]	bèifèn
备忘录[備忘錄]	bèiwànglù
背叛[背叛]	bèipàn
背诵[背誦]	bèisòng
被动[被動]	bèidòng
被告[被告]	bèigào
奔波[奔波]	bēnbō
奔驰[奔馳]	bēnchí
本能[本能]	běnnéng
本钱[本錢]	běnqián
本人[本人]	běnrén
本身[本身]	běnshēn
本事[本事]	běnshi
笨拙[笨拙]	bènzhuō
崩溃[崩潰]	bēngkuì
甭[甭]	béng
迸发[迸發]	bèngfā
蹦[蹦]	bèng
逼迫[逼迫]	bīpò
鼻涕[鼻涕]	bítì
比方[比方]	bǐfang
比喻[比喻]	bǐyù
比重[比重]	bǐzhòng
鄙视[鄙視]	bǐshì
闭塞[閉塞]	bìsè
弊病[弊病]	bìbìng
弊端[弊端]	bìduān
臂[臂]	bì
边疆[邊疆]	biānjiāng
边界[邊界]	biānjiè
边境[邊境]	biānjìng
边缘[邊緣]	biānyuán
编织[編織]	biānzhī
鞭策[鞭策]	biāncè
贬低[貶低]	biǎndī
贬义[貶義]	biǎnyì
扁[扁]	biǎn
变故[變故]	biàngù
变迁[變遷]	biànqiān
变质[變質]	biàn zhì
便利[便利]	biànlì
便条[便條]	biàntiáo
便于[便于]	biànyú
遍布[遍布]	biànbù
辨认[辨認]	biànrèn
辩护[辯護]	biànhù
辩解[辯解]	biànjiě
辩证[辯證]	biànzhèng
辫子[辮子]	biànzi
标本[標本]	biāoběn
标记[標記]	biāojì
标题[標題]	biāotí
表决[表決]	biǎojué
表态[表態]	biǎotài
表彰[表彰]	biǎozhāng
憋[憋]	biē
别墅[別墅]	biéshù
别致[別致]	biézhì
别扭[別扭]	bièniu
濒临[瀕臨]	bīnlín
冰雹[冰雹]	bīngbáo
丙[丙]	bǐng
并非[並非]	bìngfēi
并列[並列]	bìngliè
拨[撥]	bō
波浪[波浪]	bōlàng
波涛[波濤]	bōtāo
剥削[剝削]	bōxuē
播种[播種]	bōzhǒng
伯母[伯母]	bómǔ
博大精深[博大精深]	bódàjīngshēn
博览会[博覽會]	bólǎnhuì
搏斗[搏鬥]	bódòu
薄弱[薄弱]	bóruò
补偿[補償]	bǔcháng
补救[補救]	bǔjiù
补贴[補貼]	bǔtiē
捕捉[捕捉]	bǔzhuō
哺乳[哺乳]	bǔrǔ
不得已[不得已]	bùdéyǐ
不妨[不妨]	bùfáng
不敢当[不敢當]	bù gǎndāng
不顾[不顧]	búgù
不禁[不禁]	bùjīn
不堪[不堪]	bùkān
不可思议[不可思議]	bùkěsīyì
不愧[不愧]	búkuì
不料[不料]	búliào
不免[不免]	bùmiǎn
不时[不時]	bùshí
不惜[不惜]	bùxī
不相上下[不相上下]	bù xiāng shàng xià
不像话[不像話]	búxiànghuà
不屑一顾[不屑一顧]	búxièyígù
不言而喻[不言而喻]	bùyán'éryù
不由得[不由得]	bùyóude
不择手段[不擇手段]	bùzéshǒuduàn
不止[不止]	bùzhǐ
布告[布告]	bùgào
布局[布局]	bùjú
布置[布置]	bùzhì
步伐[步伐]	bùfá
部署[部署]	bùshǔ
部位[部位]	bùwèi
才干[才幹]	cáigàn
财富[財富]	cáifù
财务[財務]	cáiwù
财政[財政]	cáizhèng
裁缝[裁縫]	cáifeng
裁判[裁判]	cáipàn
裁员[裁員]	cáiyuán
采购[采購]	cǎigòu
采集[采集]	cǎijí
采纳[采納]	cǎinà
彩票[彩票]	cǎipiào
参谋[參謀]	cānmóu
参照[參照]	cānzhào
残疾[殘疾]	cánji
残酷[殘酷]	cánkù
残留[殘留]	cánliú
残忍[殘忍]	cánrěn
灿烂[燦爛]	cànlàn
仓促[倉促]	cāngcù
仓库[倉庫]	cāngkù
苍白[蒼白]	cāngbái
舱[艙]	cāng
操劳[操勞]	cāoláo
操练[操練]	cāoliàn
操纵[操縱]	cāozòng
操作[操作]	cāozuò
嘈杂[嘈雜]	cáozá
草案[草案]	cǎo'àn
草率[草率]	cǎoshuài
侧面[側面]	cèmiàn
测量[測量]	cèliáng
策划[策劃]	cèhuà
策略[策略]	cèlüè
层出不穷[層出不窮]	céng chū bù qióng
层次[層次]	céngcì
差别[差別]	chābié
插座[插座]	chāzuò
查获[查獲]	cháhuò
岔[岔]	chà
刹那[刹那]	chànà
诧异[詫異]	chàyì
柴油[柴油]	cháiyóu
搀[攙]	chān
馋[饞]	chán
缠绕[纏繞]	chánrào
产业[産業]	chǎnyè
阐述[闡述]	chǎnshù
颤抖[顫抖]	chàndǒu
昌盛[昌盛]	chāngshèng
尝试[嘗試]	chángshì
偿还[償還]	chánghuán
场合[場合]	chǎnghé
场面[場面]	chǎngmiàn
场所[場所]	chǎngsuǒ
敞开[敞開]	chǎngkāi
畅通[暢通]	chàngtōng
畅销[暢銷]	chàngxiāo
倡导[倡導]	chàngdǎo
倡议[倡議]	chàngyì
钞票[鈔票]	chāopiào
超越[超越]	chāoyuè
巢穴[巢穴]	cháoxué
朝代[朝代]	cháodài
嘲笑[嘲笑]	cháoxiào
潮流[潮流]	cháoliú
撤退[撤退]	chètuì
撤销[撤銷]	chèxiāo
沉淀[沈澱]	chéndiàn
沉闷[沈悶]	chénmèn
沉思[沈思]	chénsī
沉重[沈重]	chénzhòng
沉着[沈著]	chénzhuó
陈旧[陳舊]	chénjiù
陈列[陳列]	chénliè
陈述[陳述]	chénshù
衬托[襯托]	chèntuō
称心如意[稱心如意]	chènxīnrúyì
称号[稱號]	chēnghào
成本[成本]	chéngběn
成交[成交]	chéngjiāo
成天[成天]	chéngtiān
成效[成效]	chéngxiào
成心[成心]	chéngxīn
成员[成員]	chéngyuán
呈现[呈現]	chéngxiàn
诚挚[誠摯]	chéngzhì
承办[承辦]	chéngbàn
承包[承包]	chéngbāo
承诺[承諾]	chéngnuò
城堡[城堡]	chéngbǎo
乘[乘]	chéng
盛[盛]	chéng, shèng
惩罚[懲罰]	chéngfá
澄清[澄清]	chéngqīng
橙[橙]	chéng
秤[秤]	chèng
吃苦[吃苦]	chī kǔ
吃力[吃力]	chīlì
迟钝[遲鈍]	chídùn
迟缓[遲緩]	chíhuǎn
迟疑[遲疑]	chíyí
持久[持久]	chíjiǔ
赤道[赤道]	chìdào
赤字[赤字]	chìzì
冲动[沖動]	chōngdòng
冲击[沖擊]	chōngjī
冲突[沖突]	chōngtū
充当[充當]	chōngdāng
充沛[充沛]	chōngpèi
充实[充實]	chōngshí
充足[充足]	chōngzú
重叠[重疊]	chóngdié
崇拜[崇拜]	chóngbài
崇高[崇高]	chónggāo
崇敬[崇敬]	chóngjìng
稠密[稠密]	chóumì
筹备[籌備]	chóubèi
丑恶[醜惡]	chǒu'è
出路[出路]	chūlù
出卖[出賣]	chūmài
出身[出身]	chūshēn
出神[出神]	chū shén
出息[出息]	chūxi
初步[初步]	chūbù
除[除]	chú
处分[處分]	chǔfèn
处境[處境]	chǔjìng
处置[處置]	chǔzhì
储备[儲備]	chǔbèi
储存[儲存]	chǔcún
储蓄[儲蓄]	chǔxù
触犯[觸犯]	chùfàn
川流不息[川流不息]	chuān liú bù xī
穿越[穿越]	chuānyuè
传达[傳達]	chuándá
传单[傳單]	chuándān
传授[傳授]	chuánshòu
船舶[船舶]	chuánbó
喘气[喘氣]	chuǎnqì
串[串]	chuàn
床单[床單]	chuángdān
创立[創立]	chuànglì
创新[創新]	chuàngxīn
创业[創業]	chuàngyè
创作[創作]	chuàngzuò
吹牛[吹牛]	chuī niú
吹捧[吹捧]	chuīpěng
炊烟[炊煙]	chuīyān
垂直[垂直]	chuízhí
锤[錘]	chuí
纯粹[純粹]	chúncuì
纯洁[純潔]	chúnjié
慈善[慈善]	císhàn
慈祥[慈祥]	cíxiáng
磁带[磁帶]	cídài
雌雄[雌雄]	cíxióng
次品[次品]	cìpǐn
次序[次序]	cìxù
伺候[伺候]	cìhou
刺[刺]	cì
从容[從容]	cóngróng
丛[叢]	cóng
凑合[湊合]	còuhe
粗鲁[粗魯]	cūlǔ
窜[竄]	cuàn
摧残[摧殘]	cuīcán
脆弱[脆弱]	cuìruò
搓[搓]	cuō
磋商[磋商]	cuōshāng
挫折[挫折]	cuòzhé
搭[搭]	dā
搭档[搭檔]	dādàng
搭配[搭配]	dāpèi
达成[達成]	dá chéng
答辩[答辯]	dábiàn
答复[答複]	dáfù
打包[打包]	dǎbāo
打官司[打官司]	dǎ guānsi
打击[打擊]	dǎjī
打架[打架]	dǎ jià
打量[打量]	dǎliang
打猎[打獵]	dǎ liè
打仗[打仗]	dǎzhàng
大不了[大不了]	dàbuliǎo
大臣[大臣]	dàchén
大伙儿[大夥兒]	dàhuǒr
大肆[大肆]	dàsì
大体[大體]	dàtǐ
大意[大意]	dàyì
大致[大致]	dàzhì
歹徒[歹徒]	dǎitú
代价[代價]	dàijià
代理[代理]	dàilǐ
带领[帶領]	dàilǐng
怠慢[怠慢]	dàimàn
逮捕[逮捕]	dàibǔ
担保[擔保]	dānbǎo
胆怯[膽怯]	dǎnqiè
诞辰[誕辰]	dànchén
诞生[誕生]	dànshēng
淡季[淡季]	dànjì
淡水[淡水]	dànshuǐ
蛋白质[蛋白質]	dànbáizhì
当场[當場]	dāngchǎng
当初[當初]	dāngchū
当代[當代]	dāngdài
当面[當面]	dāng miàn
当前[當前]	dāngqián
当事人[當事人]	dāngshìrén
当务之急[當務之急]	dāngwùzhījí
当选[當選]	dāngxuǎn
党[黨]	dǎng
档案[檔案]	dàng'àn
档次[檔次]	dàngcì
导弹[導彈]	dǎodàn
导航[導航]	dǎoháng
导向[導向]	dǎoxiàng
捣乱[搗亂]	dǎo luàn
倒闭[倒閉]	dǎobì
盗窃[盜竊]	dàoqiè
稻谷[稻谷]	dàogǔ
得不偿失[得不償失]	dé bù cháng shī
得力[得力]	délì
得天独厚[得天獨厚]	détiāndúhòu
得罪[得罪]	dézuì
灯笼[燈籠]	dēnglong
登陆[登陸]	dēnglù
登录[登錄]	dēnglù
蹬[蹬]	dēng
等候[等候]	děnghòu
等级[等級]	děngjí
瞪[瞪]	dèng
堤坝[堤壩]	dībà
敌视[敵視]	díshì
抵达[抵達]	dǐdá
抵抗[抵抗]	dǐkàng
抵制[抵制]	dǐzhì
地步[地步]	dìbù
地势[地勢]	dìshì
地质[地質]	dìzhì
递增[遞增]	dìzēng
颠簸[顛簸]	diānbǒ
颠倒[顛倒]	diāndǎo
典礼[典禮]	diǎnlǐ
典型[典型]	diǎnxíng
点缀[點綴]	diǎnzhuì
电源[電源]	diànyuán
垫[墊]	diàn
惦记[惦記]	diànjì
奠定[奠定]	diàndìng
叼[叼]	diāo
雕刻[雕刻]	diāokè
雕塑[雕塑]	diāosù
吊[吊]	diào
调动[調動]	diàodòng
跌[跌]	diē
丁[丁]	dīng
叮嘱[叮囑]	dīngzhǔ
盯[盯]	dīng
定期[定期]	dìngqī
定义[定義]	dìngyì
丢人[丟人]	diū rén
丢三落四[丟三落四]	diūsān làsì
东道主[東道主]	dōngdàozhǔ
东张西望[東張西望]	dōngzhāngxīwàng
董事长[董事長]	dǒngshìzhǎng
动荡[動蕩]	dòngdàng
动机[動機]	dòngjī
动静[動靜]	dòngjìng
动力[動力]	dònglì
动脉[動脈]	dòngmài
动身[動身]	dòng shēn
动手[動手]	dòngshǒu
动态[動態]	dòngtài
动员[動員]	dòngyuán
冻结[凍結]	dòngjié
栋[棟]	dòng
兜[兜]	dōu
陡峭[陡峭]	dǒuqiào
斗争[鬥爭]	dòuzhēng
督促[督促]	dūcù
毒品[毒品]	dúpǐn
独裁[獨裁]	dúcái
堵塞[堵塞]	dǔsè
赌博[賭博]	dǔbó
杜绝[杜絕]	dùjué
端[端]	duān
端午节[端午節]	Duānwǔ Jié
端正[端正]	duānzhèng
短促[短促]	duǎncù
断定[斷定]	duàndìng
断绝[斷絕]	duànjué
堆积[堆積]	duījī
队伍[隊伍]	duìwu
对策[對策]	duìcè
对称[對稱]	duìchèn
对付[對付]	duìfu
对抗[對抗]	duìkàng
对立[對立]	duìlì
对联[對聯]	duìlián
对应[對應]	duìyìng
对照[對照]	duìzhào
兑现[兌現]	duìxiàn
顿时[頓時]	dùnshí
多元化[多元化]	duōyuánhuà
哆嗦[哆嗦]	duōsuo
堕落[墮落]	duòluò
额外[額外]	éwài
恶心[惡心]	ěxin
恶化[惡化]	èhuà
遏制[遏制]	èzhì
恩怨[恩怨]	ēnyuàn
而已[而已]	éryǐ
二氧化碳[二氧化碳]	èryǎnghuàtàn
发布[發布]	fābù
发财[發財]	fā cái
发呆[發呆]	fādāi
发动[發動]	fādòng
发觉[發覺]	fājué
发射[發射]	fāshè
发誓[發誓]	fāshì
发行[發行]	fāxíng
发炎[發炎]	fāyán
发扬[發揚]	fāyáng
发育[發育]	fāyù
法人[法人]	fǎrén
番[番]	fān
凡是[凡是]	fánshì
繁华[繁華]	fánhuá
繁忙[繁忙]	fánmáng
繁体字[繁體字]	fántǐzì
繁殖[繁殖]	fánzhí
反驳[反駁]	fǎnbó
反常[反常]	fǎncháng
反感[反感]	fǎngǎn
反抗[反抗]	fǎnkàng
反馈[反饋]	fǎnkuì
反面[反面]	fǎnmiàn
反射[反射]	fǎnshè
反思[反思]	fǎnsī
反问[反問]	fǎnwèn
反之[反之]	fǎnzhī
泛滥[泛濫]	fànlàn
范畴[範疇]	fànchóu
贩卖[販賣]	fànmài
方位[方位]	fāngwèi
方言[方言]	fāngyán
方圆[方圓]	fāngyuán
方针[方針]	fāngzhēn
防守[防守]	fángshǒu
防御[防禦]	fángyù
防止[防止]	fángzhǐ
防治[防治]	fángzhì
访问[訪問]	fǎngwèn
纺织[紡織]	fǎngzhī
放大[放大]	fàngdà
放射[放射]	fàngshè
飞禽走兽[飛禽走獸]	fēiqínzǒushòu
飞翔[飛翔]	fēixiáng
飞跃[飛躍]	fēiyuè
非法[非法]	fēifǎ
肥沃[肥沃]	féiwò
诽谤[誹謗]	fěibàng
肺[肺]	fèi
废除[廢除]	fèichú
废寝忘食[廢寢忘食]	fèiqǐnwàngshí
废墟[廢墟]	fèixū
沸腾[沸騰]	fèiténg
分辨[分辨]	fēnbiàn
分寸[分寸]	fēncun
分红[分紅]	fēn hóng
分解[分解]	fēnjiě
分裂[分裂]	fēnliè
分泌[分泌]	fēnmì
分明[分明]	fēnmíng
分歧[分歧]	fēnqí
分散[分散]	fēnsàn
吩咐[吩咐]	fēnfù
坟墓[墳墓]	fénmù
粉末[粉末]	fěnmò
粉色[粉色]	fěnsè
粉碎[粉碎]	fěnsuì
分量[分量]	fènliàng
愤怒[憤怒]	fènnù
丰满[豐滿]	fēngmǎn
丰盛[豐盛]	fēngshèng
丰收[豐收]	fēngshōu
风暴[風暴]	fēngbào
风度[風度]	fēngdù
风光[風光]	fēngguāng
风气[風氣]	fēngqì
风趣[風趣]	fēngqù
风土人情[風土人情]	fēngtǔrénqíng
风味[風味]	fēngwèi
封闭[封閉]	fēngbì
封建[封建]	fēngjiàn
封锁[封鎖]	fēngsuǒ
锋利[鋒利]	fēnglì
逢[逢]	féng
奉献[奉獻]	fèngxiàn
否决[否決]	fǒujué
夫妇[夫婦]	fūfù
夫人[夫人]	fūrén
敷衍[敷衍]	fūyǎn
服从[服從]	fúcóng
服气[服氣]	fúqì
俘虏[俘虜]	fúlǔ
符号[符號]	fúhào
幅度[幅度]	fúdù
辐射[輻射]	fúshè
福利[福利]	fúlì
福气[福氣]	fúqì
抚摸[撫摸]	fǔmō
抚养[撫養]	fǔyǎng
俯视[俯視]	fǔshì
辅助[輔助]	fǔzhù
腐败[腐敗]	fǔbài
腐烂[腐爛]	fǔlàn
腐蚀[腐蝕]	fǔshí
腐朽[腐朽]	fǔxiǔ
负担[負擔]	fùdān
附和[附和]	fùhè
附件[附件]	fùjiàn
附属[附屬]	fùshǔ
复活[複活]	fùhuó
复兴[複興]	fùxīng
副[副]	fù
赋予[賦予]	fùyǔ
富裕[富裕]	fùyù
腹泻[腹瀉]	fùxiè
覆盖[覆蓋]	fùgài
改良[改良]	gǎiliáng
钙[鈣]	gài
盖章[蓋章]	gàizhāng
干旱[幹旱]	gānhàn
干扰[幹擾]	gānrǎo
干涉[幹涉]	gānshè
干预[幹預]	gānyù
尴尬[尴尬]	gāngà
感慨[感慨]	gǎnkǎi
感染[感染]	gǎnrǎn
干劲[幹勁]	gànjìn
纲领[綱領]	gānglǐng
岗位[崗位]	gǎngwèi
港口[港口]	gǎngkǒu
港湾[港灣]	gǎngwān
杠杆[杠杆]	gànggǎn
高超[高超]	gāochāo
高潮[高潮]	gāocháo
高峰[高峰]	gāofēng
高明[高明]	gāomíng
高尚[高尚]	gāoshàng
高涨[高漲]	gāozhǎng
稿件[稿件]	gǎojiàn
告辞[告辭]	gàocí
告诫[告誡]	gàojiè
疙瘩[疙瘩]	gēda
鸽子[鴿子]	gēzi
搁[擱]	gē
割[割]	gē
歌颂[歌頌]	gēsòng
革命[革命]	gémìng
格局[格局]	géjú
格式[格式]	géshì
隔阂[隔閡]	géhé
隔离[隔離]	gélí
个体[個體]	gètǐ
各抒己见[各抒己見]	gèshūjǐjiàn
根深蒂固[根深蒂固]	gēn shēn dì gù
根源[根源]	gēnyuán
跟前[跟前]	gēnqián
跟随[跟隨]	gēnsuí
跟踪[跟蹤]	gēnzōng
更新[更新]	gēngxīn
更正[更正]	gēngzhèng
耕地[耕地]	gēngdì
工艺品[工藝品]	gōngyìpǐn
公安局[公安局]	gōngānjú
公道[公道]	gōngdao
公告[公告]	gōnggào
公关[公關]	gōngguān
公民[公民]	gōngmín
公然[公然]	gōngrán
公认[公認]	gōngrèn
公式[公式]	gōngshì
公务[公務]	gōngwù
公正[公正]	gōngzhèng
公证[公證]	gōngzhèng
功劳[功勞]	gōngláo
功效[功效]	gōngxiào
攻击[攻擊]	gōngjī
攻克[攻克]	gōngkè
供不应求[供不應求]	gōng bú yìng qiú
供给[供給]	gōngjǐ
宫殿[宮殿]	gōngdiàn
恭敬[恭敬]	gōngjìng
巩固[鞏固]	gǒnggù
共和国[共和國]	gònghéguó
共计[共計]	gòngjì
共鸣[共鳴]	gòngmíng
勾结[勾結]	gōujié
钩子[鈎子]	gōuzi
构思[構思]	gòusī
孤独[孤獨]	gūdú
孤立[孤立]	gūlì
姑且[姑且]	gūqiě
辜负[辜負]	gūfù
古董[古董]	gǔdǒng
古怪[古怪]	gǔguài
股东[股東]	gǔdōng
股份[股份]	gǔfèn
骨干[骨幹]	gǔgàn
鼓动[鼓動]	gǔdòng
固然[固然]	gùrán
固体[固體]	gùtǐ
固有[固有]	gùyǒu
固执[固執]	gùzhí
故乡[故鄉]	gùxiāng
故障[故障]	gùzhàng
顾虑[顧慮]	gùlǜ
顾问[顧問]	gùwèn
雇佣[雇傭]	gùyōng
拐杖[拐杖]	guǎizhàng
关怀[關懷]	guānhuái
关照[關照]	guānzhào
观光[觀光]	guānguāng
官方[官方]	guānfāng
管辖[管轄]	guǎnxiá
贯彻[貫徹]	guànchè
惯例[慣例]	guànlì
灌溉[灌溉]	guàngài
罐[罐]	guàn
光彩[光彩]	guāngcǎi
光辉[光輝]	guānghuī
光芒[光芒]	guāngmáng
光荣[光榮]	guāngróng
广阔[廣闊]	guǎngkuò
归根到底[歸根到底]	guī gēn dào dǐ
归还[歸還]	guīhuán
规范[規範]	guīfàn
规格[規格]	guīgé
规划[規劃]	guīhuà
规章[規章]	guīzhāng
轨道[軌道]	guǐdào
贵族[貴族]	guìzú
跪[跪]	guì
棍棒[棍棒]	gùnbàng
国防[國防]	guófáng
国务院[國務院]	guówùyuàn
果断[果斷]	guǒduàn
过度[過度]	guòdù
过渡[過渡]	guòdù
过奖[過獎]	guòjiǎng
过滤[過濾]	guòlǜ
过失[過失]	guòshī
过问[過問]	guòwèn
过瘾[過瘾]	guòyǐn
过于[過于]	guòyú
嗨[嗨]	hāi
海拔[海拔]	hǎibá
海滨[海濱]	hǎibīn
含糊[含糊]	hánhu
含义[含義]	hányì
寒暄[寒暄]	hánxuān
罕见[罕見]	hǎnjiàn
捍卫[捍衛]	hànwèi
行列[行列]	hángliè
航空[航空]	hángkōng
航天[航天]	hángtiān
航行[航行]	hángxíng
毫米[毫米]	háomǐ
毫无[毫無]	háo wú
豪迈[豪邁]	háomài
号召[號召]	hàozhào
耗费[耗費]	hàofèi
呵[呵]	hē
合并[合並]	hébìng
合成[合成]	héchéng
合伙[合夥]	héhuǒ
合算[合算]	hésuàn
和蔼[和藹]	hé'ǎi
和解[和解]	héjiě
和睦[和睦]	hémù
和气[和氣]	héqi
和谐[和諧]	héxié
嘿[嘿]	hēi
痕迹[痕迹]	hénjì
狠心[狠心]	hěn xīn
恨不得[恨不得]	hèn bu de
横[橫]	héng
哼[哼]	hēng
轰动[轟動]	hōngdòng
烘[烘]	hōng
宏观[宏觀]	hóngguān
宏伟[宏偉]	hóngwěi
洪水[洪水]	hóngshuǐ
哄[哄]	hǒng
喉咙[喉嚨]	hóulóng
吼[吼]	hǒu
后代[後代]	hòudài
后顾之忧[後顧之憂]	hòugùzhīyōu
后勤[後勤]	hòuqín
候选[候選]	hòuxuǎn
呼唤[呼喚]	hūhuàn
呼啸[呼嘯]	hūxiào
呼吁[呼籲]	hūyù
忽略[忽略]	hūlüè
胡乱[胡亂]	húluàn
胡须[胡須]	húxū
湖泊[湖泊]	húpō
花瓣[花瓣]	huābàn
花蕾[花蕾]	huālěi
华丽[華麗]	huálì
华侨[華僑]	huáqiáo
化肥[化肥]	huàféi
化石[化石]	huàshí
化验[化驗]	huàyàn
化妆[化妝]	huà zhuāng
划分[劃分]	huàfēn
画蛇添足[畫蛇添足]	huàshétiānzú
话筒[話筒]	huàtǒng
欢乐[歡樂]	huānlè
还原[還原]	huányuán
环节[環節]	huánjié
缓和[緩和]	huǎnhé
患者[患者]	huànzhě
荒凉[荒涼]	huāngliáng
荒谬[荒謬]	huāngmiù
荒唐[荒唐]	huāngtang
皇帝[皇帝]	huángdì
皇后[皇後]	huánghòu
黄昏[黃昏]	huánghūn
恍然大悟[恍然大悟]	huǎngrándàwù
晃[晃]	huàng
挥霍[揮霍]	huīhuò
辉煌[輝煌]	huīhuáng
回报[回報]	huíbào
回避[回避]	huíbì
回顾[回顧]	huígù
回收[回收]	huíshōu
悔恨[悔恨]	huǐhèn
毁灭[毀滅]	huǐmiè
汇报[彙報]	huìbào
会晤[會晤]	huìwù
贿赂[賄賂]	huìlù
昏迷[昏迷]	hūnmí
荤[葷]	hūn
浑身[渾身]	húnshēn
混合[混合]	hùnhé
混乱[混亂]	hùnluàn
混淆[混淆]	hùnxiáo
混浊[混濁]	hùnzhuó
活该[活該]	huógāi
活力[活力]	huólì
火箭[火箭]	huǒjiàn
火焰[火焰]	huǒyàn
火药[火藥]	huǒyào
货币[貨幣]	huòbì
讥笑[譏笑]	jīxiào
饥饿[饑餓]	jī'è
机动[機動]	jīdòng
机构[機構]	jīgòu
机灵[機靈]	jīling
机密[機密]	jīmì
机械[機械]	jīxiè
机遇[機遇]	jīyù
机智[機智]	jīzhì
基地[基地]	jīdì
基金[基金]	jījīn
基因[基因]	jīyīn
激发[激發]	jīfā
激励[激勵]	jīlì
激情[激情]	jīqíng
及早[及早]	jízǎo
吉祥[吉祥]	jíxiáng
级别[級別]	jíbié
极端[極端]	jíduān
极限[極限]	jíxiàn
即便[即便]	jíbiàn
即将[即將]	jíjiāng
急功近利[急功近利]	jígōngjìnlì
急剧[急劇]	jíjù
急切[急切]	jíqiè
急于求成[急于求成]	jíyúqiúchéng
急躁[急躁]	jízào
疾病[疾病]	jíbìng
集团[集團]	jítuán
嫉妒[嫉妒]	jídù
籍贯[籍貫]	jíguàn
给予[給予]	jǐyǔ
计较[計較]	jìjiào
记性[記性]	jìxing
记载[記載]	jìzǎi
纪要[紀要]	jìyào
技巧[技巧]	jìqiǎo
忌讳[忌諱]	jìhuì
季度[季度]	jìdù
季军[季軍]	jìjūn
迹象[迹象]	jìxiàng
继承[繼承]	jìchéng
寄托[寄托]	jìtuō
寂静[寂靜]	jìjìng
加工[加工]	jiā gōng
加剧[加劇]	jiājù
夹杂[夾雜]	jiāzá
佳肴[佳肴]	jiāyáo
家常[家常]	jiācháng
家伙[家夥]	jiāhuo
家属[家屬]	jiāshǔ
家喻户晓[家喻戶曉]	jiā yù hù xiǎo
尖端[尖端]	jiānduān
尖锐[尖銳]	jiānruì
坚定[堅定]	jiāndìng
坚固[堅固]	jiāngù
坚韧[堅韌]	jiānrèn
坚实[堅實]	jiānshí
坚硬[堅硬]	jiānyìng
艰难[艱難]	jiānnán
监督[監督]	jiāndū
监视[監視]	jiānshì
监狱[監獄]	jiānyù
煎[煎]	jiān
拣[揀]	jiǎn
检讨[檢討]	jiǎntǎo
检验[檢驗]	jiǎnyàn
剪彩[剪彩]	jiǎn cǎi
简化[簡化]	jiǎnhuà
简陋[簡陋]	jiǎnlòu
简体字[簡體字]	jiǎntǐzì
简要[簡要]	jiǎnyào
见多识广[見多識廣]	jiànduōshíguǎng
见解[見解]	jiànjiě
见闻[見聞]	jiànwén
见义勇为[見義勇爲]	jiànyìyǒngwéi
间谍[間諜]	jiàndié
间隔[間隔]	jiàngé
间接[間接]	jiànjiē
剑[劍]	jiàn
健全[健全]	jiànquán
舰艇[艦艇]	jiàntǐng
践踏[踐踏]	jiàntà
溅[濺]	jiàn
鉴别[鑒別]	jiànbié
鉴定[鑒定]	jiàndìng
鉴于[鑒于]	jiànyú
将近[將近]	jiāngjìn
将就[將就]	jiāngjiu
将军[將軍]	jiāngjūn
僵硬[僵硬]	jiāngyìng
奖励[獎勵]	jiǎnglì
奖赏[獎賞]	jiǎngshǎng
桨[槳]	jiǎng
降临[降臨]	jiànglín
交叉[交叉]	jiāochā
交代[交代]	jiāodài
交涉[交涉]	jiāoshè
交易[交易]	jiāoyì
娇气[嬌氣]	jiāoqì
焦点[焦點]	jiāodiǎn
焦急[焦急]	jiāojí
角落[角落]	jiǎoluò
侥幸[僥幸]	jiǎoxìng
搅拌[攪拌]	jiǎobàn
缴纳[繳納]	jiǎonà
较量[較量]	jiàoliàng
教养[教養]	jiàoyǎng
阶层[階層]	jiēcéng
皆[皆]	jiē
接连[接連]	jiēlián
揭露[揭露]	jiēlù
节制[節制]	jiézhì
节奏[節奏]	jiézòu
杰出[傑出]	jiéchū
结晶[結晶]	jiéjīng
结局[結局]	jiéjú
结算[結算]	jiésuàn
截止[截止]	jiézhǐ
截至[截至]	jiézhì
竭尽全力[竭盡全力]	jiéjìn quánlì
解除[解除]	jiěchú
解放[解放]	jiěfàng
解雇[解雇]	jiěgù
解剖[解剖]	jiěpōu
解散[解散]	jiěsàn
解体[解體]	jiětǐ
戒备[戒備]	jièbèi
界限[界限]	jièxiàn
借鉴[借鑒]	jièjiàn
借助[借助]	jièzhù
金融[金融]	jīnróng
津津有味[津津有味]	jīnjīn yǒu wèi
紧迫[緊迫]	jǐnpò
锦上添花[錦上添花]	jǐnshàngtiānhuā
进而[進而]	jìn'ér
进攻[進攻]	jìngōng
进化[進化]	jìnhuà
进展[進展]	jìnzhǎn
近来[近來]	jìnlái
晋升[晉升]	jìnshēng
浸泡[浸泡]	jìnpào
茎[莖]	jīng
经费[經費]	jīngfèi
经纬[經緯]	jīngwěi
惊动[驚動]	jīngdòng
惊奇[驚奇]	jīngqí
惊讶[驚訝]	jīngyà
兢兢业业[兢兢業業]	jīngjīng yèyè
精打细算[精打細算]	jīng dǎ xì suàn
精华[精華]	jīnghuá
精简[精簡]	jīngjiǎn
精密[精密]	jīngmì
精确[精確]	jīngquè
精通[精通]	jīngtōng
精心[精心]	jīngxīn
精益求精[精益求精]	jīng yì qiú jīng
精致[精致]	jīngzhì
井[井]	jǐng
颈椎[頸椎]	jǐngzhuī
警告[警告]	jǐnggào
警惕[警惕]	jǐngtì
竞赛[競賽]	jìngsài
竞选[競選]	jìngxuǎn
敬礼[敬禮]	jìnglǐ
敬业[敬業]	jìngyè
境界[境界]	jìngjiè
镜头[鏡頭]	jìngtóu
纠纷[糾紛]	jiūfēn
纠正[糾正]	jiūzhèng
酒精[酒精]	jiǔjīng
救济[救濟]	jiùjì
就近[就近]	jiùjìn
就业[就業]	jiùyè
就职[就職]	jiù zhí
拘留[拘留]	jūliú
拘束[拘束]	jūshù
居民[居民]	jūmín
居住[居住]	jūzhù
鞠躬[鞠躬]	jūgōng
局部[局部]	júbù
局面[局面]	júmiàn
局势[局勢]	júshì
局限[局限]	júxiàn
咀嚼[咀嚼]	jǔjué
沮丧[沮喪]	jǔsàng
举动[舉動]	jǔdòng
举世瞩目[舉世矚目]	jǔshì zhǔmù
举足轻重[舉足輕重]	jǔzúqīngzhòng
剧本[劇本]	jùběn
剧烈[劇烈]	jùliè
据悉[據悉]	jùxī
聚精会神[聚精會神]	jù jīng huì shén
卷[卷]	juǎn
决策[決策]	juécè
觉悟[覺悟]	juéwù
觉醒[覺醒]	juéxǐng
绝望[絕望]	jué wàng
倔强[倔強]	juéjiàng
军队[軍隊]	jūnduì
君子[君子]	jūnzǐ
卡通[卡通]	kǎtōng
开采[開采]	kāicǎi
开除[開除]	kāichú
开阔[開闊]	kāikuò
开朗[開朗]	kāilǎng
开明[開明]	kāimíng
开辟[開辟]	kāipì
开拓[開拓]	kāituò
开展[開展]	kāizhǎn
开支[開支]	kāizhī
刊登[刊登]	kāndēng
刊物[刊物]	kānwù
勘探[勘探]	kāntàn
侃侃而谈[侃侃而談]	kǎnkǎn'értán
砍伐[砍伐]	kǎnfá
看待[看待]	kàndài
慷慨[慷慨]	kāngkǎi
扛[扛]	káng
抗议[抗議]	kàngyì
考察[考察]	kǎochá
考古[考古]	kǎogǔ
考核[考核]	kǎohé
考验[考驗]	kǎoyàn
靠拢[靠攏]	kàolǒng
科目[科目]	kēmù
磕[磕]	kē
可观[可觀]	kěguān
可口[可口]	kěkǒu
可恶[可惡]	kěwù
可行[可行]	kěxíng
渴望[渴望]	kěwàng
克制[克制]	kèzhì
刻不容缓[刻不容緩]	kèbùrónghuǎn
客户[客戶]	kèhù
课题[課題]	kètí
恳切[懇切]	kěnqiè
啃[啃]	kěn
坑[坑]	kēng
空洞[空洞]	kōngdòng
空前绝后[空前絕後]	kōngqiánjuéhòu
空想[空想]	kōngxiǎng
空虚[空虛]	kōngxū
孔[孔]	kǒng
恐怖[恐怖]	kǒngbù
恐吓[恐嚇]	kǒnghè
恐惧[恐懼]	kǒngjù
空白[空白]	kòngbái
空隙[空隙]	kòngxì
口气[口氣]	kǒuqì
口腔[口腔]	kǒuqiāng
口头[口頭]	kǒutóu
口音[口音]	kǒuyīn
扣[扣]	kòu
枯萎[枯萎]	kūwěi
枯燥[枯燥]	kūzào
哭泣[哭泣]	kūqì
苦尽甘来[苦盡甘來]	kǔjìngānlái
苦涩[苦澀]	kǔsè
挎[挎]	kuà
跨[跨]	kuà
快活[快活]	kuàihuo
宽敞[寬敞]	kuānchang
宽容[寬容]	kuānróng
款待[款待]	kuǎndài
款式[款式]	kuǎnshì
筐[筐]	kuāng
旷课[曠課]	kuàng kè
况且[況且]	kuàngqiě
矿产[礦産]	kuàngchǎn
框架[框架]	kuàngjià
亏待[虧待]	kuīdài
亏损[虧損]	kuīsǔn
捆绑[捆綁]	kǔnbǎng
扩充[擴充]	kuòchōng
扩散[擴散]	kuòsàn
扩张[擴張]	kuòzhāng
喇叭[喇叭]	lǎba
蜡烛[蠟燭]	làzhú
啦[啦]	la
来历[來曆]	láilì
来源[來源]	láiyuán
栏目[欄目]	lánmù
懒惰[懶惰]	lǎnduò
狼狈[狼狽]	lángbèi
狼吞虎咽[狼吞虎咽]	lángtūnhǔyàn
捞[撈]	lāo
牢固[牢固]	láogù
牢骚[牢騷]	láosāo
唠叨[唠叨]	láodao
乐趣[樂趣]	lèqù
乐意[樂意]	lèyì
雷达[雷達]	léidá
类似[類似]	lèisì
冷酷[冷酷]	lěngkù
冷落[冷落]	lěngluò
冷却[冷卻]	lěngquè
愣[愣]	lèng
黎明[黎明]	límíng
礼节[禮節]	lǐjié
礼尚往来[禮尚往來]	lǐshàngwǎnglái
里程碑[裏程碑]	lǐchéngbēi
理睬[理睬]	lǐcǎi
理所当然[理所當然]	lǐ suǒ dāng rán
理直气壮[理直氣壯]	lǐzhíqìzhuàng
理智[理智]	lǐzhì
力求[力求]	lìqiú
力所能及[力所能及]	lìsuǒnéngjí
力争[力爭]	lìzhēng
历代[曆代]	lìdài
历来[曆來]	lìlái
立场[立場]	lìchǎng
立方[立方]	lìfāng
立交桥[立交橋]	lìjiāoqiáo
立体[立體]	lìtǐ
立足[立足]	lìzú
利害[利害]	lìhai
例外[例外]	lìwài
粒[粒]	lì
连年[連年]	liánnián
连锁[連鎖]	liánsuǒ
连同[連同]	liántóng
联欢[聯歡]	liánhuān
联络[聯絡]	liánluò
联盟[聯盟]	liánméng
联想[聯想]	liánxiǎng
廉洁[廉潔]	liánjié
良心[良心]	liángxīn
谅解[諒解]	liàngjiě
晾[晾]	liàng
辽阔[遼闊]	liáokuò
列举[列舉]	lièjǔ
临床[臨床]	línchuáng
淋[淋]	lín
吝啬[吝啬]	lìnsè
伶俐[伶俐]	línglì
灵感[靈感]	línggǎn
灵魂[靈魂]	línghún
灵敏[靈敏]	língmǐn
凌晨[淩晨]	língchén
零星[零星]	língxīng
领会[領會]	lǐnghuì
领事馆[領事館]	lǐngshìguǎn
领土[領土]	lǐngtǔ
领悟[領悟]	lǐngwù
领先[領先]	lǐngxiān
领袖[領袖]	lǐngxiù
溜[溜]	liū
留恋[留戀]	liúliàn
留念[留念]	liúniàn
留神[留神]	liú shén
流浪[流浪]	liúlàng
流露[流露]	liúlù
流氓[流氓]	liúmáng
流通[流通]	liútōng
聋哑[聾啞]	lóngyǎ
隆重[隆重]	lóngzhòng
垄断[壟斷]	lǒngduàn
笼罩[籠罩]	lǒngzhào
搂[摟]	lǒu
炉灶[爐竈]	lúzào
屡次[屢次]	lǚcì
履行[履行]	lǚxíng
掠夺[掠奪]	lüèduó
轮船[輪船]	lúnchuán
轮廓[輪廓]	lúnkuò
轮胎[輪胎]	lúntāi
论坛[論壇]	lùntán
论证[論證]	lùnzhèng
啰唆[啰唆]	luōsuo
络绎不绝[絡繹不絕]	luòyìbùjué
落成[落成]	luòchéng
落实[落實]	luòshí
麻痹[麻痹]	mábì
麻木[麻木]	mámù
麻醉[麻醉]	mázuì
码头[碼頭]	mǎtou
蚂蚁[螞蟻]	mǎyǐ
嘛[嘛]	ma, má
埋伏[埋伏]	máifu
埋没[埋沒]	máimò
埋葬[埋葬]	máizàng
迈[邁]	mài
脉搏[脈搏]	màibó
埋怨[埋怨]	mányuàn
蔓延[蔓延]	mànyán
漫长[漫長]	màncháng
漫画[漫畫]	mànhuà
慢性[慢性]	mànxìng
忙碌[忙碌]	mánglù
盲目[盲目]	mángmù
茫茫[茫茫]	mángmáng
茫然[茫然]	mángrán
茂盛[茂盛]	màoshèng
冒充[冒充]	màochōng
冒犯[冒犯]	màofàn
枚[枚]	méi
媒介[媒介]	méijiè
美观[美觀]	měiguān
美满[美滿]	měimǎn
美妙[美妙]	měimiào
萌芽[萌芽]	méngyá
猛烈[猛烈]	měngliè
眯[眯]	mī
弥补[彌補]	míbǔ
弥漫[彌漫]	mímàn
迷惑[迷惑]	míhuò
迷人[迷人]	mírén
迷信[迷信]	míxìn
谜语[謎語]	míyǔ
密度[密度]	mìdù
密封[密封]	mìfēng
棉花[棉花]	miánhua
免得[免得]	miǎnde
免疫[免疫]	miǎnyì
勉励[勉勵]	miǎnlì
勉强[勉強]	miǎnqiǎng
面貌[面貌]	miànmào
面子[面子]	miànzi
描绘[描繪]	miáohuì
瞄准[瞄准]	miáozhǔn
渺小[渺小]	miǎoxiǎo
藐视[藐視]	miǎoshì
灭亡[滅亡]	mièwáng
蔑视[蔑視]	mièshì
民间[民間]	mínjiān
民主[民主]	mínzhǔ
敏捷[敏捷]	mǐnjié
敏锐[敏銳]	mǐnruì
名次[名次]	míngcì
名额[名額]	míng'é
名副其实[名副其實]	míng fù qí shí
名誉[名譽]	míngyù
明明[明明]	míngmíng
明智[明智]	míngzhì
命名[命名]	mìngmíng
摸索[摸索]	mōsuǒ
模范[模範]	mófàn
模式[模式]	móshì
模型[模型]	móxíng
膜[膜]	mó
摩擦[摩擦]	mócā
磨合[磨合]	móhé
魔鬼[魔鬼]	móguǐ
魔术[魔術]	móshù
抹杀[抹殺]	mǒshā
莫名其妙[莫名其妙]	mòmíngqímiào
墨水儿[墨水兒]	mòshuǐer
默默[默默]	mòmò
谋求[謀求]	móuqiú
模样[模樣]	múyàng
母语[母語]	mǔyǔ
目睹[目睹]	mùdǔ
目光[目光]	mùguāng
沐浴[沐浴]	mùyù
拿手[拿手]	náshǒu
纳闷儿[納悶兒]	nà mènr
耐用[耐用]	nàiyòng
南辕北辙[南轅北轍]	nányuánběizhé
难得[難得]	nándé
难堪[難堪]	nánkān
难能可贵[難能可貴]	nánnéngkěguì
恼火[惱火]	nǎohuǒ
内涵[內涵]	nèihán
内幕[內幕]	nèimù
内在[內在]	nèizài
能量[能量]	néngliàng
拟定[擬定]	nǐdìng
逆行[逆行]	nìxíng
年度[年度]	niándù
捏[捏]	niē
凝固[凝固]	nínggù
凝聚[凝聚]	níngjù
凝视[凝視]	níngshì
拧[擰]	níng
宁肯[甯肯]	nìngkěn
宁愿[甯願]	nìngyuàn
扭转[扭轉]	niǔzhuǎn
纽扣儿[紐扣兒]	niǔkòur
农历[農曆]	nónglì
浓厚[濃厚]	nónghòu
奴隶[奴隸]	núlì
虐待[虐待]	nüèdài
挪[挪]	nuó
哦[哦]	ò
殴打[毆打]	ōudǎ
呕吐[嘔吐]	ǒutù
偶像[偶像]	ǒuxiàng
趴[趴]	pā
排斥[排斥]	páichì
排除[排除]	páichú
排放[排放]	páifàng
排练[排練]	páiliàn
徘徊[徘徊]	páihuái
派别[派別]	pàibié
派遣[派遣]	pàiqiǎn
攀登[攀登]	pāndēng
盘旋[盤旋]	pánxuán
判决[判決]	pànjué
畔[畔]	pàn
庞大[龐大]	pángdà
抛弃[抛棄]	pāoqì
泡沫[泡沫]	pàomò
培育[培育]	péiyù
配备[配備]	pèibèi
配偶[配偶]	pèi'ǒu
配套[配套]	pèi tào
盆地[盆地]	péndì
烹饪[烹饪]	pēngrèn
捧[捧]	pěng
批发[批發]	pīfā
批判[批判]	pīpàn
劈[劈]	pī
皮革[皮革]	pígé
疲惫[疲憊]	píbèi
疲倦[疲倦]	píjuàn
屁股[屁股]	pìgu
譬如[譬如]	pìrú
偏差[偏差]	piānchā
偏见[偏見]	piānjiàn
偏僻[偏僻]	piānpì
偏偏[偏偏]	piānpiān
片断[片斷]	piànduàn
片刻[片刻]	piànkè
漂浮[漂浮]	piāofú
飘扬[飄揚]	piāoyáng
撇[撇]	piě
拼搏[拼搏]	pīnbó
拼命[拼命]	pīn mìng
贫乏[貧乏]	pínfá
贫困[貧困]	pínkùn
频繁[頻繁]	pínfán
频率[頻率]	pínlǜ
品尝[品嘗]	pǐncháng
品德[品德]	pǐndé
品质[品質]	pǐnzhì
品种[品種]	pǐnzhǒng
平凡[平凡]	píngfán
平面[平面]	píngmiàn
平坦[平坦]	píngtǎn
平行[平行]	píngxíng
平庸[平庸]	píngyōng
平原[平原]	píngyuán
评估[評估]	pínggū
评论[評論]	pínglùn
屏幕[屏幕]	píngmù
屏障[屏障]	píngzhàng
坡[坡]	pō
泼[潑]	pō
颇[頗]	pō
迫不及待[迫不及待]	pòbùjídài
迫害[迫害]	pòhài
破例[破例]	pòlì
魄力[魄力]	pòlì
扑[撲]	pū
铺[鋪]	pù, pū
朴实[樸實]	pǔshí
朴素[樸素]	pǔsù
普及[普及]	pǔjí
瀑布[瀑布]	pùbù
凄凉[淒涼]	qīliáng
期望[期望]	qīwàng
期限[期限]	qīxiàn
欺负[欺負]	qīfu
欺骗[欺騙]	qīpiàn
齐全[齊全]	qíquán
齐心协力[齊心協力]	qíxīnxiélì
奇妙[奇妙]	qímiào
歧视[歧視]	qíshì
旗袍[旗袍]	qípáo
旗帜[旗幟]	qízhì
乞丐[乞丐]	qǐgài
岂有此理[豈有此理]	qǐ yǒu cǐ lǐ
企图[企圖]	qǐtú
启程[啓程]	qǐchéng
启蒙[啓蒙]	qǐméng
启示[啓示]	qǐshì
启事[啓事]	qǐshì
起草[起草]	qǐ cǎo
起初[起初]	qǐchū
起伏[起伏]	qǐfú
起哄[起哄]	qǐ hòng
起码[起碼]	qǐmǎ
起源[起源]	qǐyuán
气概[氣概]	qìgài
气功[氣功]	qìgōng
气魄[氣魄]	qìpò
气色[氣色]	qìsè
气势[氣勢]	qìshì
气味[氣味]	qìwèi
气象[氣象]	qìxiàng
气压[氣壓]	qìyā
气质[氣質]	qìzhì
迄今为止[迄今爲止]	qìjīnwéizhǐ
器材[器材]	qìcái
器官[器官]	qìguān
掐[掐]	qiā
洽谈[洽談]	qiàtán
恰当[恰當]	qiàdàng
恰到好处[恰到好處]	qià dào hǎo chù
恰巧[恰巧]	qiàqiǎo
千方百计[千方百計]	qiān fāng bǎi jì
迁就[遷就]	qiānjiù
迁徙[遷徙]	qiānxǐ
牵[牽]	qiān
牵扯[牽扯]	qiānchě
牵制[牽制]	qiānzhì
谦逊[謙遜]	qiānxùn
签署[簽署]	qiānshǔ
前景[前景]	qiánjǐng
前提[前提]	qiántí
潜力[潛力]	qiánlì
潜水[潛水]	qiánshuǐ
潜移默化[潛移默化]	qiányímòhuà
谴责[譴責]	qiǎnzé
强制[強制]	qiángzhì
抢劫[搶劫]	qiǎngjié
抢救[搶救]	qiǎngjiù
强迫[強迫]	qiǎngpò
桥梁[橋梁]	qiáoliáng
窍门[竅門]	qiàomén
翘[翹]	qiào
切实[切實]	qièshí
锲而不舍[锲而不舍]	qiè'érbùshě
钦佩[欽佩]	qīnpèi
侵犯[侵犯]	qīnfàn
侵略[侵略]	qīnlüè
亲密[親密]	qīnmì
亲热[親熱]	qīnrè
勤俭[勤儉]	qínjiǎn
勤劳[勤勞]	qínláo
倾听[傾聽]	qīngtīng
倾向[傾向]	qīngxiàng
倾斜[傾斜]	qīngxié
清澈[清澈]	qīngchè
清晨[清晨]	qīngchén
清除[清除]	qīngchú
清洁[清潔]	qīngjié
清理[清理]	qīnglǐ
清晰[清晰]	qīngxī
清醒[清醒]	qīngxǐng
清真[清真]	qīngzhēn
情报[情報]	qíngbào
情节[情節]	qíngjié
情理[情理]	qínglǐ
情形[情形]	qíngxing
晴朗[晴朗]	qínglǎng
请柬[請柬]	qǐngjiǎn
请教[請教]	qǐngjiào
请示[請示]	qǐngshì
请帖[請帖]	qǐngtiě
丘陵[丘陵]	qiūlíng
区分[區分]	qūfēn
区域[區域]	qūyù
曲折[曲折]	qūzhé
驱逐[驅逐]	qūzhú
屈服[屈服]	qūfú
渠道[渠道]	qúdào
曲子[曲子]	qǔzi
取缔[取締]	qǔdì
趣味[趣味]	qùwèi
圈套[圈套]	quāntào
权衡[權衡]	quánhéng
权威[權威]	quánwēi
全局[全局]	quánjú
全力以赴[全力以赴]	quán lì yǐ fù
拳头[拳頭]	quántou
犬[犬]	quǎn
缺口[缺口]	quēkǒu
缺席[缺席]	quē xí
缺陷[缺陷]	quēxiàn
瘸[瘸]	qué
确保[確保]	quèbǎo
确立[確立]	quèlì
确切[確切]	quèqiè
确信[確信]	quèxìn
群众[群衆]	qúnzhòng
染[染]	rǎn
嚷[嚷]	rǎng
让步[讓步]	ràng bù
饶恕[饒恕]	ráoshù
扰乱[擾亂]	rǎoluàn
惹祸[惹禍]	rěhuò
热泪盈眶[熱淚盈眶]	rè lèi yíng kuàng
热门[熱門]	rèmén
人道[人道]	réndào
人格[人格]	réngé
人工[人工]	réngōng
人家[人家]	rénjiā
人间[人間]	rénjiān
人士[人士]	rénshì
人为[人爲]	rénwéi
人性[人性]	rénxìng
人质[人質]	rénzhì
仁慈[仁慈]	réncí
忍耐[忍耐]	rěnnài
忍受[忍受]	rěnshòu
认定[認定]	rèndìng
认可[認可]	rènkě
任命[任命]	rènmìng
任性[任性]	rènxìng
任意[任意]	rènyì
任重道远[任重道遠]	rènzhòngdàoyuǎn
仍旧[仍舊]	réngjiù
日新月异[日新月異]	rìxīnyuèyì
日益[日益]	rìyì
荣幸[榮幸]	róngxìng
荣誉[榮譽]	róngyù
容貌[容貌]	róngmào
容纳[容納]	róngnà
容器[容器]	róngqì
容忍[容忍]	róngrěn
溶解[溶解]	róngjiě
融化[融化]	rónghuà
融洽[融洽]	róngqià
柔和[柔和]	róuhé
揉[揉]	róu
儒家[儒家]	rújiā
若干[若幹]	ruògān
弱点[弱點]	ruòdiǎn
撒谎[撒謊]	sā huǎng
散文[散文]	sǎnwén
散布[散布]	sànbù
散发[散發]	sànfā
丧失[喪失]	sàngshī
骚扰[騷擾]	sāorǎo
嫂子[嫂子]	sǎozi
刹车[刹車]	shā chē
啥[啥]	shá
筛选[篩選]	shāixuǎn
山脉[山脈]	shānmài
闪烁[閃爍]	shǎnshuò
擅长[擅長]	shàncháng
擅自[擅自]	shànzì
伤脑筋[傷腦筋]	shāng nǎojīn
商标[商標]	shāngbiāo
上级[上級]	shàngjí
上进[上進]	shàngjìn
上任[上任]	shàng rèn
上瘾[上瘾]	shàngyǐn
上游[上遊]	shàngyóu
尚且[尚且]	shàngqiě
捎[捎]	shāo
梢[梢]	shāo
哨[哨]	shào
奢侈[奢侈]	shēchǐ
舌头[舌頭]	shétou
设立[設立]	shèlì
设想[設想]	shèxiǎng
设置[設置]	shèzhì
社区[社區]	shèqū
涉及[涉及]	shèjí
摄氏度[攝氏度]	shèshìdù
申报[申報]	shēnbào
呻吟[呻吟]	shēnyín
绅士[紳士]	shēnshì
深奥[深奧]	shēn'ào
深沉[深沈]	shēnchén
深情厚谊[深情厚誼]	shēnqínghòuyì
神经[神經]	shénjīng
神奇[神奇]	shénqí
神气[神氣]	shénqì
神圣[神聖]	shénshèng
神态[神態]	shéntài
神仙[神仙]	shénxiān
审查[審查]	shěnchá
审理[審理]	shěnlǐ
审美[審美]	shěnměi
审判[審判]	shěnpàn
渗透[滲透]	shèntòu
慎重[慎重]	shènzhòng
生存[生存]	shēngcún
生机[生機]	shēngjī
生理[生理]	shēnglǐ
生疏[生疏]	shēngshū
生态[生態]	shēngtài
生物[生物]	shēngwù
生肖[生肖]	shēngxiào
生效[生效]	shēng xiào
生锈[生鏽]	shēngxiù
生育[生育]	shēngyù
声明[聲明]	shēngmíng
声势[聲勢]	shēngshì
声誉[聲譽]	shēngyù
牲畜[牲畜]	shēngchù
省会[省會]	shěnghuì
胜负[勝負]	shèngfù
盛产[盛産]	shèngchǎn
盛开[盛開]	shèngkāi
盛情[盛情]	shèngqíng
盛行[盛行]	shèngxíng
尸体[屍體]	shītǐ
失事[失事]	shī shì
失误[失誤]	shīwù
失踪[失蹤]	shī zōng
师范[師範]	shīfàn
施加[施加]	shījiā
施展[施展]	shīzhǎn
十足[十足]	shízú
石油[石油]	shíyóu
时常[時常]	shícháng
时而[時而]	shí'ér
时光[時光]	shíguāng
时机[時機]	shíjī
时事[時事]	shíshì
识别[識別]	shíbié
实惠[實惠]	shíhuì
实力[實力]	shílì
实施[實施]	shíshī
实事求是[實事求是]	shí shì qiú shì
实行[實行]	shíxíng
实质[實質]	shízhì
拾[拾]	shí
使命[使命]	shǐmìng
示范[示範]	shìfàn
示威[示威]	shìwēi
示意[示意]	shìyì
世代[世代]	shìdài
势必[勢必]	shìbì
势力[勢力]	shìli
事故[事故]	shìgù
事迹[事迹]	shìjì
事件[事件]	shìjiàn
事态[事態]	shìtài
事务[事務]	shìwù
事项[事項]	shìxiàng
事业[事業]	shìyè
试图[試圖]	shìtú
试验[試驗]	shìyàn
视力[視力]	shìlì
视频[視頻]	shìpín
视线[視線]	shìxiàn
视野[視野]	shìyě
是非[是非]	shìfēi
适宜[適宜]	shìyí
逝世[逝世]	shìshì
释放[釋放]	shìfàng
收藏[收藏]	shōucáng
收缩[收縮]	shōusuō
收益[收益]	shōuyì
收音机[收音機]	shōuyīnjī
手法[手法]	shǒufǎ
手势[手勢]	shǒushì
手艺[手藝]	shǒuyì
守护[守護]	shǒuhù
首饰[首飾]	shǒushì
首要[首要]	shǒuyào
受罪[受罪]	shòuzuì
授予[授予]	shòuyǔ
书法[書法]	shūfǎ
书籍[書籍]	shūjí
书记[書記]	shūji
书面[書面]	shūmiàn
舒畅[舒暢]	shūchàng
疏忽[疏忽]	shūhu
疏远[疏遠]	shūyuǎn
束[束]	shù
束缚[束縛]	shùfù
树立[樹立]	shùlì
竖[豎]	shù
数额[數額]	shù'é
耍[耍]	shuǎ
衰老[衰老]	shuāilǎo
衰退[衰退]	shuāituì
率领[率領]	shuàilǐng
涮火锅[涮火鍋]	shuànhuǒguō
双胞胎[雙胞胎]	shuāngbāotāi
爽快[爽快]	shuǎngkuài
水利[水利]	shuǐlì
水龙头[水龍頭]	shuǐlóngtóu
水泥[水泥]	shuǐní
瞬间[瞬間]	shùnjiān
司法[司法]	sīfǎ
司令[司令]	sīlìng
私自[私自]	sīzì
思念[思念]	sīniàn
思索[思索]	sīsuǒ
思维[思維]	sīwéi
斯文[斯文]	sīwen
死亡[死亡]	sǐwáng
四肢[四肢]	sìzhī
寺庙[寺廟]	sìmiào
饲养[飼養]	sìyǎng
肆无忌惮[肆無忌憚]	sìwújìdàn
耸[聳]	sǒng
艘[艘]	sōu
苏醒[蘇醒]	sūxǐng
俗话[俗話]	súhuà
诉讼[訴訟]	sùsòng
素食[素食]	sùshí
素质[素質]	sùzhì
塑造[塑造]	sùzào
算数[算數]	suànshù
随即[隨即]	suíjí
随意[隨意]	suíyì
岁月[歲月]	suìyuè
隧道[隧道]	suìdào
损坏[損壞]	sǔnhuài
索取[索取]	suǒqǔ
索性[索性]	suǒxìng
塌[塌]	tā
踏实[踏實]	tāshi
塔[塔]	tǎ
台风[台風]	táifēng
太空[太空]	tàikōng
泰斗[泰鬥]	tàidǒu
贪婪[貪婪]	tānlán
贪污[貪汙]	tānwū
摊[攤]	tān
瘫痪[癱瘓]	tānhuàn
弹性[彈性]	tánxìng
坦白[坦白]	tǎnbái
叹气[歎氣]	tàn qì
探测[探測]	tàncè
探索[探索]	tànsuǒ
探讨[探討]	tàntǎo
探望[探望]	tànwàng
倘若[倘若]	tǎngruò
掏[掏]	tāo
滔滔不绝[滔滔不絕]	tāotāo bù jué
陶瓷[陶瓷]	táocí
陶醉[陶醉]	táozuì
淘汰[淘汰]	táotài
讨好[討好]	tǎohǎo
特长[特長]	tècháng
特定[特定]	tèdìng
特意[特意]	tèyì
提拔[提拔]	tíbá
提炼[提煉]	tíliàn
提示[提示]	tíshì
提议[提議]	tíyì
题材[題材]	tícái
体裁[體裁]	tǐcái
体积[體積]	tǐjī
体谅[體諒]	tǐliàng
体面[體面]	tǐmiàn
体系[體系]	tǐxì
天才[天才]	tiāncái
天赋[天賦]	tiānfù
天伦之乐[天倫之樂]	tiānlúnzhīlè
天然气[天然氣]	tiānránqì
天生[天生]	tiānshēng
天堂[天堂]	tiāntáng
天文[天文]	tiānwén
田径[田徑]	tiánjìng
田野[田野]	tiányě
舔[舔]	tiǎn
挑剔[挑剔]	tiāoti
条款[條款]	tiáokuǎn
条理[條理]	tiáolǐ
条约[條約]	tiáoyuē
调和[調和]	tiáohé
调剂[調劑]	tiáojì
调节[調節]	tiáojié
调解[調解]	tiáojiě
调料[調料]	tiáoliào
挑拨[挑撥]	tiǎobō
挑衅[挑釁]	tiǎoxìn
跳跃[跳躍]	tiàoyuè
亭子[亭子]	tíngzi
停泊[停泊]	tíngbó
停顿[停頓]	tíngdùn
停滞[停滯]	tíngzhì
挺拔[挺拔]	tǐngbá
通货膨胀[通貨膨脹]	tōnghuò péngzhàng
通缉[通緝]	tōngjī
通俗[通俗]	tōngsú
通讯[通訊]	tōngxùn
通用[通用]	tōngyòng
同胞[同胞]	tóngbāo
同志[同志]	tóngzhì
铜[銅]	tóng
童话[童話]	tónghuà
统筹兼顾[統籌兼顧]	tǒngchóujiāngù
统计[統計]	tǒngjì
统统[統統]	tǒngtǒng
统治[統治]	tǒngzhì
投机[投機]	tóujī
投票[投票]	tóupiào
投诉[投訴]	tóusù
投降[投降]	tóuxiáng
投掷[投擲]	tóuzhì
透露[透露]	tòulù
秃[禿]	tū
突破[突破]	tūpò
图案[圖案]	tú'àn
徒弟[徒弟]	túdì
途径[途徑]	tújìng
涂抹[塗抹]	túmǒ
土壤[土壤]	tǔrǎng
团结[團結]	tuánjié
团体[團體]	tuántǐ
团圆[團圓]	tuányuán
推测[推測]	tuīcè
推翻[推翻]	tuīfān
推理[推理]	tuīlǐ
推论[推論]	tuīlùn
推销[推銷]	tuīxiāo
吞吞吐吐[吞吞吐吐]	tūntūntǔtǔ
托运[托運]	tuōyùn
拖延[拖延]	tuōyán
脱离[脫離]	tuōlí
妥当[妥當]	tuǒdang
妥善[妥善]	tuǒshàn
妥协[妥協]	tuǒxié
椭圆[橢圓]	tuǒyuán
唾弃[唾棄]	tuòqì
挖掘[挖掘]	wājué
哇[哇]	wa
娃娃[娃娃]	wáwa
瓦解[瓦解]	wǎjiě
歪曲[歪曲]	wāiqū
外表[外表]	wàibiǎo
外行[外行]	wàiháng
外界[外界]	wàijiè
外向[外向]	wàixiàng
丸[丸]	wán
完备[完備]	wánbèi
完毕[完畢]	wánbì
玩弄[玩弄]	wánnòng
玩意儿[玩意兒]	wányìr
顽固[頑固]	wángù
顽强[頑強]	wánqiáng
挽回[挽回]	wǎnhuí
挽救[挽救]	wǎnjiù
惋惜[惋惜]	wǎnxī
万分[萬分]	wànfēn
往常[往常]	wǎngcháng
往事[往事]	wǎngshì
妄想[妄想]	wàngxiǎng
危机[危機]	wēijī
威风[威風]	wēifēng
威力[威力]	wēilì
威望[威望]	wēiwàng
威信[威信]	wēixìn
微不足道[微不足道]	wēi bù zú dào
微观[微觀]	wēiguān
为难[爲難]	wéinán
为期[爲期]	wéiqī
违背[違背]	wéibèi
唯独[唯獨]	wéidú
维持[維持]	wéichí
维护[維護]	wéihù
维生素[維生素]	wéishēngsù
伪造[僞造]	wěizào
委托[委托]	wěituō
委员[委員]	wěiyuán
卫星[衛星]	wèixīng
未免[未免]	wèimiǎn
畏惧[畏懼]	wèijù
喂[喂]	wèi, wéi
蔚蓝[蔚藍]	wèilán
慰问[慰問]	wèiwèn
温带[溫帶]	wēndài
温和[溫和]	wēnhé
文凭[文憑]	wénpíng
文物[文物]	wénwù
文献[文獻]	wénxiàn
文雅[文雅]	wényǎ
文艺[文藝]	wényì
问世[問世]	wènshì
窝[窩]	wō
乌黑[烏黑]	wūhēi
污蔑[汙蔑]	wūmiè
诬陷[誣陷]	wūxiàn
无比[無比]	wúbǐ
无偿[無償]	wúcháng
无耻[無恥]	wúchǐ
无动于衷[無動于衷]	wúdòngyúzhōng
无非[無非]	wúfēi
无辜[無辜]	wúgū
无精打采[無精打采]	wújīngdǎcǎi
无赖[無賴]	wúlài
无理取闹[無理取鬧]	wúlǐqǔnào
无能为力[無能爲力]	wú néng wéi lì
无穷无尽[無窮無盡]	wúqióngwújìn
无微不至[無微不至]	wú wēi bú zhì
无忧无虑[無憂無慮]	wúyōuwúlǜ
无知[無知]	wúzhī
武器[武器]	wǔqì
武侠[武俠]	wǔxiá
武装[武裝]	wǔzhuāng
侮辱[侮辱]	wǔrǔ
舞蹈[舞蹈]	wǔdǎo
务必[務必]	wùbì
物美价廉[物美價廉]	wùměijiàlián
物业[物業]	wùyè
物资[物資]	wùzī
误差[誤差]	wùchā
误解[誤解]	wùjiě
夕阳[夕陽]	xīyáng
昔日[昔日]	xīrì
牺牲[犧牲]	xīshēng
溪[溪]	xī
熄灭[熄滅]	xīmiè
膝盖[膝蓋]	xīgài
习俗[習俗]	xísú
袭击[襲擊]	xíjī
媳妇[媳婦]	xífù
喜闻乐见[喜聞樂見]	xǐwénlèjiàn
喜悦[喜悅]	xǐyuè
系列[系列]	xìliè
细胞[細胞]	xìbāo
细菌[細菌]	xìjūn
细致[細致]	xìzhì
峡谷[峽谷]	xiágǔ
狭隘[狹隘]	xiá'ài
狭窄[狹窄]	xiázhǎi
霞[霞]	xiá
下属[下屬]	xiàshǔ
先进[先進]	xiānjìn
先前[先前]	xiānqián
纤维[纖維]	xiānwéi
掀起[掀起]	xiānqǐ
鲜明[鮮明]	xiānmíng
闲话[閑話]	xiánhuà
贤惠[賢惠]	xiánhuì
弦[弦]	xián
衔接[銜接]	xiánjiē
嫌[嫌]	xián
嫌疑[嫌疑]	xiányí
显著[顯著]	xiǎnzhù
现场[現場]	xiànchǎng
现成[現成]	xiànchéng
现状[現狀]	xiànzhuàng
线索[線索]	xiànsuǒ
宪法[憲法]	xiànfǎ
陷害[陷害]	xiànhài
陷阱[陷阱]	xiànjǐng
陷入[陷入]	xiànrù
馅儿[餡兒]	xiànr
乡镇[鄉鎮]	xiāngzhèn
相差[相差]	xiāngchà
相等[相等]	xiāngděng
相辅相成[相輔相成]	xiāngfǔxiāngchéng
相应[相應]	xiāngyìng
镶嵌[鑲嵌]	xiāngqiàn
响亮[響亮]	xiǎngliàng
响应[響應]	xiǎngyìng
想方设法[想方設法]	xiǎng fāng shè fǎ
向导[向導]	xiàngdǎo
向来[向來]	xiànglái
向往[向往]	xiàngwǎng
巷[巷]	xiàng
相声[相聲]	xiàngsheng
削[削]	xuē
消除[消除]	xiāochú
消毒[消毒]	xiāo dú
消防[消防]	xiāofáng
消耗[消耗]	xiāohào
消灭[消滅]	xiāomiè
销毁[銷毀]	xiāohuǐ
潇洒[潇灑]	xiāosǎ
小心翼翼[小心翼翼]	xiǎoxīn yìyì
肖像[肖像]	xiàoxiàng
效益[效益]	xiàoyì
协会[協會]	xiéhuì
协商[協商]	xiéshāng
协调[協調]	xiétiáo
协议[協議]	xiéyì
协助[協助]	xiézhù
携带[攜帶]	xiédài
泄露[泄露]	xièlòu
泄气[泄氣]	xièqì
屑[屑]	xiè
谢绝[謝絕]	xièjué
心得[心得]	xīndé
心甘情愿[心甘情願]	xīngānqíngyuàn
心灵[心靈]	xīnlíng
心态[心態]	xīntài
心疼[心疼]	xīnténg
心血[心血]	xīnxuè
心眼儿[心眼兒]	xīnyǎnr
辛勤[辛勤]	xīnqín
欣慰[欣慰]	xīnwèi
欣欣向荣[欣欣向榮]	xīnxīn xiàng róng
新陈代谢[新陳代謝]	xīn chén dàixiè
新郎[新郎]	xīnláng
新娘[新娘]	xīnniáng
新颖[新穎]	xīnyǐng
薪水[薪水]	xīnshuǐ
信赖[信賴]	xìnlài
信念[信念]	xìnniàn
信仰[信仰]	xìnyǎng
信誉[信譽]	xìnyù
兴隆[興隆]	xīnglóng
兴旺[興旺]	xīngwàng
腥[腥]	xīng
刑事[刑事]	xíngshì
行政[行政]	xíngzhèng
形态[形態]	xíngtài
兴高采烈[興高采烈]	xìng gāo cǎi liè
兴致勃勃[興致勃勃]	xìngzhìbóbó
性感[性感]	xìnggǎn
性命[性命]	xìngmìng
性能[性能]	xìngnéng
凶恶[凶惡]	xiōng'è
凶手[凶手]	xiōngshǒu
汹涌[洶湧]	xiōngyǒng
胸怀[胸懷]	xiōnghuái
胸膛[胸膛]	xiōngtáng
雄厚[雄厚]	xiónghòu
雄伟[雄偉]	xióngwěi
修复[修複]	xiūfù
修建[修建]	xiūjiàn
修养[修養]	xiūyǎng
羞耻[羞恥]	xiūchǐ
绣[繡]	xiù
嗅觉[嗅覺]	xiùjué
须知[須知]	xūzhī
虚假[虛假]	xūjiǎ
虚荣[虛榮]	xūróng
虚伪[虛僞]	xūwěi
需求[需求]	xūqiú
许可[許可]	xǔkě
序言[序言]	xùyán
畜牧[畜牧]	xùmù
酗酒[酗酒]	xùjiǔ
宣誓[宣誓]	xuān shì
宣扬[宣揚]	xuānyáng
喧哗[喧嘩]	xuānhuá
悬挂[懸挂]	xuánguà
悬念[懸念]	xuánniàn
悬殊[懸殊]	xuánshū
悬崖峭壁[懸崖峭壁]	xuányáqiàobì
旋律[旋律]	xuánlǜ
旋转[旋轉]	xuánzhuǎn
选拔[選拔]	xuǎnbá
选举[選舉]	xuǎnjǔ
选手[選手]	xuǎnshǒu
炫耀[炫耀]	xuànyào
削弱[削弱]	xuēruò
学说[學說]	xuéshuō
学位[學位]	xuéwèi
雪上加霜[雪上加霜]	xuěshàngjiāshuāng
血压[血壓]	xuèyā
熏陶[熏陶]	xūntáo
寻觅[尋覓]	xúnmì
巡逻[巡邏]	xúnluó
循环[循環]	xúnhuán
循序渐进[循序漸進]	xún xù jiàn jìn
压迫[壓迫]	yāpò
压岁钱[壓歲錢]	yāsuìqián
压缩[壓縮]	yāsuō
压抑[壓抑]	yāyì
压榨[壓榨]	yāzhà
压制[壓制]	yāzhì
鸦雀无声[鴉雀無聲]	yāquèwúshēng
亚军[亞軍]	yàjūn
烟花爆竹[煙花爆竹]	yānhuābàozhú
淹没[淹沒]	yānmò
延期[延期]	yán qī
延伸[延伸]	yánshēn
延续[延續]	yánxù
严寒[嚴寒]	yánhán
严禁[嚴禁]	yánjìn
严峻[嚴峻]	yánjùn
严厉[嚴厲]	yánlì
严密[嚴密]	yánmì
言论[言論]	yánlùn
岩石[岩石]	yánshí
炎热[炎熱]	yánrè
沿海[沿海]	yánhǎi
掩盖[掩蓋]	yǎngài
掩护[掩護]	yǎnhù
掩饰[掩飾]	yǎnshì
眼光[眼光]	yǎnguāng
眼色[眼色]	yǎnsè
眼神[眼神]	yǎnshén
演变[演變]	yǎnbiàn
演习[演習]	yǎnxí
演绎[演繹]	yǎnyì
演奏[演奏]	yǎnzòu
厌恶[厭惡]	yànwù
验收[驗收]	yànshōu
验证[驗證]	yànzhèng
氧气[氧氣]	yǎngqì
样品[樣品]	yàngpǐn
谣言[謠言]	yáoyán
摇摆[搖擺]	yáobǎi
摇滚[搖滾]	yáogǔn
遥控[遙控]	yáokòng
遥远[遙遠]	yáoyuǎn
要点[要點]	yàodiǎn
要命[要命]	yàomìng
要素[要素]	yàosù
耀眼[耀眼]	yàoyǎn
野蛮[野蠻]	yěmán
野心[野心]	yěxīn
液体[液體]	yètǐ
一度[一度]	yídù
一帆风顺[一帆風順]	yìfānfēngshùn
一贯[一貫]	yíguàn
一举两得[一舉兩得]	yìjǔliǎngdé
一流[一流]	yīliú
一目了然[一目了然]	yímùliǎorán
一如既往[一如既往]	yìrújìwǎng
一丝不苟[一絲不苟]	yìsībùgǒu
一向[一向]	yíxiàng
衣裳[衣裳]	yīshang
依旧[依舊]	yījiù
依据[依據]	yījù
依靠[依靠]	yīkào
依赖[依賴]	yīlài
依托[依托]	yītuō
仪器[儀器]	yíqì
仪式[儀式]	yíshì
遗产[遺産]	yíchǎn
遗传[遺傳]	yíchuán
遗留[遺留]	yíliú
遗失[遺失]	yíshī
疑惑[疑惑]	yíhuò
以便[以便]	yǐbiàn
以免[以免]	yǐmiǎn
以往[以往]	yǐwǎng
以至[以至]	yǐzhì
以致[以致]	yǐzhì
亦[亦]	yì
异常[異常]	yìcháng
意料[意料]	yìliào
意识[意識]	yìshi
意图[意圖]	yìtú
意味着[意味著]	yìwèizhe
意向[意向]	yìxiàng
意志[意志]	yìzhì
毅力[毅力]	yìlì
毅然[毅然]	yìrán
翼[翼]	yì
阴谋[陰謀]	yīnmóu
音响[音響]	yīnxiǎng
引导[引導]	yǐndǎo
引擎[引擎]	yǐnqíng
引用[引用]	yǐnyòng
饮食[飲食]	yǐnshí
隐蔽[隱蔽]	yǐnbì
隐患[隱患]	yǐnhuàn
隐瞒[隱瞞]	yǐnmán
隐私[隱私]	yǐnsī
隐约[隱約]	yǐnyuē
英明[英明]	yīngmíng
英勇[英勇]	yīngyǒng
婴儿[嬰兒]	yīng'ér
迎面[迎面]	yíng miàn
盈利[盈利]	yínglì
应酬[應酬]	yìngchou
应邀[應邀]	yìngyāo
拥护[擁護]	yōnghù
拥有[擁有]	yōngyǒu
庸俗[庸俗]	yōngsú
永恒[永恒]	yǒnghéng
勇于[勇于]	yǒngyú
涌现[湧現]	yǒngxiàn
踊跃[踴躍]	yǒngyuè
用户[用戶]	yònghù
优胜劣汰[優勝劣汰]	yōushèngliètài
优先[優先]	yōuxiān
优异[優異]	yōuyì
优越[優越]	yōuyuè
忧郁[憂郁]	yōuyù
犹如[猶如]	yóurú
油腻[油膩]	yóunì
油漆[油漆]	yóuqī
有条不紊[有條不紊]	yǒutiáobùwěn
幼稚[幼稚]	yòuzhì
诱惑[誘惑]	yòuhuò
渔民[漁民]	yúmín
愚蠢[愚蠢]	yúchǔn
愚昧[愚昧]	yúmèi
舆论[輿論]	yúlùn
与日俱增[與日俱增]	yǔrìjùzēng
宇宙[宇宙]	yǔzhòu
羽绒服[羽絨服]	yǔróngfú
玉[玉]	yù
预料[預料]	yùliào
预期[預期]	yùqī
预算[預算]	yùsuàn
预先[預先]	yùxiān
预言[預言]	yùyán
预兆[預兆]	yùzhào
欲望[欲望]	yùwàng
寓言[寓言]	yùyán
愈[愈]	yù
冤枉[冤枉]	yuānwang
元首[元首]	yuánshǒu
元素[元素]	yuánsù
元宵节[元宵節]	Yuánxiāo Jié
园林[園林]	yuánlín
原告[原告]	yuángào
原理[原理]	yuánlǐ
原始[原始]	yuánshǐ
原先[原先]	yuánxiān
圆满[圓滿]	yuánmǎn
缘故[緣故]	yuángù
源泉[源泉]	yuánquán
约束[約束]	yuēshù
乐谱[樂譜]	yuèpǔ
岳母[嶽母]	yuèmǔ
孕育[孕育]	yùnyù
运算[運算]	yùnsuàn
运行[運行]	yùnxíng
酝酿[醞釀]	yùnniàng
蕴藏[蘊藏]	yùncáng
熨[熨]	yùn
杂技[雜技]	zájì
杂交[雜交]	zájiāo
砸[砸]	zá
咋[咋]	zǎ
灾难[災難]	zāinàn
栽培[栽培]	zāipéi
宰[宰]	zǎi
再接再厉[再接再厲]	zàijiēzàilì
在意[在意]	zài yì
攒[攢]	zǎn
暂且[暫且]	zànqiě
赞叹[贊歎]	zàntàn
赞助[贊助]	zànzhù
遭受[遭受]	zāoshòu
遭殃[遭殃]	zāo yāng
遭遇[遭遇]	zāoyù
糟蹋[糟蹋]	zāotà
造型[造型]	zàoxíng
噪音[噪音]	zàoyīn
责怪[責怪]	zéguài
贼[賊]	zéi
增添[增添]	zēngtiān
赠送[贈送]	zèngsòng
扎[紮]	zhā
扎实[紮實]	zhāshi
渣[渣]	zhā
眨[眨]	zhǎ
诈骗[詐騙]	zhàpiàn
摘要[摘要]	zhāiyào
债券[債券]	zhàiquàn
沾光[沾光]	zhān guāng
瞻仰[瞻仰]	zhānyǎng
斩钉截铁[斬釘截鐵]	zhǎn dīng jié tiě
展示[展示]	zhǎnshì
展望[展望]	zhǎnwàng
展现[展現]	zhǎnxiàn
崭新[嶄新]	zhǎnxīn
占据[占據]	zhànjù
占领[占領]	zhànlǐng
战斗[戰鬥]	zhàndòu
战略[戰略]	zhànlüè
战术[戰術]	zhànshù
战役[戰役]	zhànyì
章程[章程]	zhāngchéng
帐篷[帳篷]	zhàngpeng
障碍[障礙]	zhàng'ài
招标[招標]	zhāobiāo
招收[招收]	zhāoshōu
朝气蓬勃[朝氣蓬勃]	zhāo qì péng bó
着迷[著迷]	zháomí
沼泽[沼澤]	zhǎozé
照样[照樣]	zhàoyàng
照耀[照耀]	zhàoyào
折腾[折騰]	zhēteng
遮挡[遮擋]	zhēdǎng
折[折]	zhé
折磨[折磨]	zhémo
侦探[偵探]	zhēntàn
珍贵[珍貴]	zhēnguì
珍稀[珍稀]	zhēnxī
珍珠[珍珠]	zhēnzhū
真理[真理]	zhēnlǐ
真相[真相]	zhēnxiàng
真挚[真摯]	zhēnzhì
斟酌[斟酌]	zhēnzhuó
枕头[枕頭]	zhěntou
阵地[陣地]	zhèndì
阵容[陣容]	zhènróng
振奋[振奮]	zhènfèn
振兴[振興]	zhènxīng
震撼[震撼]	zhènhàn
震惊[震驚]	zhènjīng
镇定[鎮定]	zhèndìng
镇静[鎮靜]	zhènjìng
正月[正月]	zhēngyuè
争端[爭端]	zhēngduān
争夺[爭奪]	zhēngduó
争气[爭氣]	zhēng qì
争先恐后[爭先恐後]	zhēng xiān kǒng hòu
争议[爭議]	zhēngyì
征服[征服]	zhēngfú
征收[征收]	zhēngshōu
挣扎[掙紮]	zhēngzhá
蒸发[蒸發]	zhēngfā
整顿[整頓]	zhěngdùn
正当[正當]	zhèng dāng
正负[正負]	zhèngfù
正规[正規]	zhèngguī
正经[正經]	zhèngjing
正气[正氣]	zhèngqì
正义[正義]	zhèngyì
正宗[正宗]	zhèngzōng
证实[證實]	zhèngshí
证书[證書]	zhèngshū
郑重[鄭重]	zhèngzhòng
政策[政策]	zhèngcè
政权[政權]	zhèngquán
症状[症狀]	zhèngzhuàng
之际[之際]	zhījì
支撑[支撐]	zhīchēng
支出[支出]	zhīchū
支流[支流]	zhīliú
支配[支配]	zhīpèi
支援[支援]	zhīyuán
支柱[支柱]	zhīzhù
枝[枝]	zhī
知觉[知覺]	zhījué
知足常乐[知足常樂]	zhīzúchánglè
脂肪[脂肪]	zhīfáng
执行[執行]	zhíxíng
执着[執著]	zhízhuó
直播[直播]	zhíbō
直径[直徑]	zhíjìng
侄子[侄子]	zhízi
值班[值班]	zhí bān
职能[職能]	zhínéng
职位[職位]	zhíwèi
职务[職務]	zhíwù
殖民地[殖民地]	zhímíndì
指标[指標]	zhǐbiāo
指定[指定]	zhǐdìng
指甲[指甲]	zhǐjia
指令[指令]	zhǐlìng
指南针[指南針]	zhǐnánzhēn
指示[指示]	zhǐshì
指望[指望]	zhǐwàng
指责[指責]	zhǐzé
志气[志氣]	zhìqì
制裁[制裁]	zhìcái
制服[制服]	zhìfú
制约[制約]	zhìyuē
制止[制止]	zhìzhǐ
治安[治安]	zhì'ān
治理[治理]	zhìlǐ
致辞[致辭]	zhìcí
致力[致力]	zhìlì
致使[致使]	zhìshǐ
智力[智力]	zhìlì
智能[智能]	zhìnéng
智商[智商]	zhìshāng
滞留[滯留]	zhìliú
中断[中斷]	zhōngduàn
中立[中立]	zhōnglì
中央[中央]	zhōngyāng
忠诚[忠誠]	zhōngchéng
忠实[忠實]	zhōngshí
终点[終點]	zhōngdiǎn
终究[終究]	zhōngjiū
终身[終身]	zhōngshēn
终止[終止]	zhōngzhǐ
衷心[衷心]	zhōngxīn
肿瘤[腫瘤]	zhǒngliú
种子[種子]	zhǒngzi
种族[種族]	zhǒngzú
众所周知[衆所周知]	zhòng suǒ zhōu zhī
种植[種植]	zhòngzhí
重心[重心]	zhòngxīn
舟[舟]	zhōu
州[州]	zhōu
周边[周邊]	zhōubiān
周密[周密]	zhōumì
周年[周年]	zhōunián
周期[周期]	zhōuqī
周折[周折]	zhōuzhé
周转[周轉]	zhōuzhuǎn
粥[粥]	zhōu
昼夜[晝夜]	zhòuyè
皱纹[皺紋]	zhòuwén
株[株]	zhū
诸位[諸位]	zhūwèi
逐年[逐年]	zhúnián
主办[主辦]	zhǔbàn
主导[主導]	zhǔdǎo
主管[主管]	zhǔguǎn
主流[主流]	zhǔliú
主权[主權]	zhǔquán
主义[主義]	zhǔyì
拄[拄]	zhǔ
嘱咐[囑咐]	zhǔfù
助理[助理]	zhùlǐ
助手[助手]	zhùshǒu
住宅[住宅]	zhùzhái
注射[注射]	zhùshè
注视[注視]	zhùshì
注释[注釋]	zhùshì
注重[注重]	zhùzhòng
驻扎[駐紮]	zhùzhā
著作[著作]	zhùzuò
铸造[鑄造]	zhùzào
拽[拽]	zhuài
专长[專長]	zhuāncháng
专程[專程]	zhuānchéng
专利[專利]	zhuānlì
专题[專題]	zhuāntí
砖[磚]	zhuān
转达[轉達]	zhuǎndá
转让[轉讓]	zhuǎnràng
转移[轉移]	zhuǎnyí
转折[轉折]	zhuǎnzhé
传记[傳記]	zhuànjì
庄稼[莊稼]	zhuāngjia
庄严[莊嚴]	zhuāngyán
庄重[莊重]	zhuāngzhòng
装备[裝備]	zhuāngbèi
装卸[裝卸]	zhuāngxiè
壮观[壯觀]	zhuàngguān
壮丽[壯麗]	zhuànglì
壮烈[壯烈]	zhuàngliè
幢[幢]	zhuàng
追悼[追悼]	zhuīdào
追究[追究]	zhuījiū
坠[墜]	zhuì
准则[准則]	zhǔnzé
卓越[卓越]	zhuóyuè
着手[著手]	zhuóshǒu
着想[著想]	zhuóxiǎng
着重[著重]	zhuózhòng
琢磨[琢磨]	zuómo
姿态[姿態]	zītài
资本[資本]	zīběn
资产[資産]	zīchǎn
资深[資深]	zīshēn
资助[資助]	zīzhù
滋润[滋潤]	zīrùn
滋味[滋味]	zīwèi
子弹[子彈]	zǐdàn
自卑[自卑]	zìbēi
自发[自發]	zìfā
自力更生[自力更生]	zì lì gēng shēng
自满[自滿]	zìmǎn
自主[自主]	zìzhǔ
宗教[宗教]	zōngjiào
宗旨[宗旨]	zōngzhǐ
棕色[棕色]	zōngsè
踪迹[蹤迹]	zōngjì
总而言之[總而言之]	zǒngéryánzhī
总和[總和]	zǒnghé
纵横[縱橫]	zònghéng
走廊[走廊]	zǒuláng
走漏[走漏]	zǒulòu
走私[走私]	zǒu sī
揍[揍]	zòu
租赁[租賃]	zūlìn
足以[足以]	zúyǐ
阻碍[阻礙]	zǔ'ài
阻拦[阻攔]	zǔlán
阻挠[阻撓]	zǔnáo
祖父[祖父]	zǔfù
祖国[祖國]	zǔguó
祖先[祖先]	zǔxiān
钻研[鑽研]	zuānyán
钻石[鑽石]	zuànshí
嘴唇[嘴唇]	zuǐchún
罪犯[罪犯]	zuìfàn
尊严[尊嚴]	zūnyán
遵循[遵循]	zūnxún
作弊[作弊]	zuòbì
作废[作廢]	zuòfèi
作风[作風]	zuòfēng
作息[作息]	zuòxī
座右铭[座右銘]	zuòyòumíng
做主[做主]	zuòzhǔ